"";"sub";"cond";"item";"seq";"start_time";"end_time";"duration_ms"
"9";1;3;63;1;599444;605214;5770
"10";1;3;79;2;607758;613639;5881
"11";1;3;43;3;617703;625930;8227
"12";1;3;67;4;628829;634813;5984
"13";1;1;69;5;637386;642863;5477
"14";1;3;11;6;645851;650912;5061
"16";1;1;5;7;657845;662912;5067
"18";1;3;31;8;668871;675836;6965
"20";1;1;21;9;681306;686761;5455
"22";1;3;59;10;692191;696627;4436
"23";1;1;89;11;699626;704035;4409
"24";1;1;65;12;706891;711293;4402
"25";1;1;13;13;714637;718493;3856
"27";1;3;75;14;723478;730159;6681
"28";1;3;83;15;733133;738242;5109
"29";1;3;55;16;741993;748150;6157
"30";1;1;33;17;752409;755592;3183
"32";1;1;81;18;761103;764150;3047
"33";1;1;93;19;767862;771916;4054
"34";1;3;27;20;775928;781999;6071
"36";1;3;91;21;787146;792266;5120
"37";1;3;15;22;795312;800940;5628
"39";1;1;9;23;806952;809973;3021
"41";1;3;95;24;815582;820606;5024
"42";1;1;57;25;823474;826573;3099
"43";1;1;41;26;829162;833472;4310
"44";1;1;49;27;836856;840755;3899
"45";1;1;73;28;844268;847355;3087
"46";1;1;61;29;850151;854113;3962
"47";1;1;97;30;902933;906786;3853
"48";1;1;53;31;909737;913778;4041
"49";1;3;99;32;916621;920944;4323
"50";1;3;51;33;924870;928702;3832
"51";1;1;85;34;931470;934169;2699
"52";1;1;37;35;937756;941202;3446
"54";1;3;87;36;946749;951527;4778
"55";1;1;29;37;954200;957901;3701
"57";1;1;1;38;962824;966309;3485
"59";1;3;71;39;971783;975701;3918
"60";1;1;45;40;978263;981251;2988
"61";1;3;3;41;984020;988817;4797
"63";1;3;7;42;994011;998558;4547
"65";1;3;35;43;1003377;1007924;4547
"67";1;3;47;44;1013765;1018241;4476
"68";1;1;77;45;1021417;1025049;3632
"69";1;1;25;46;1028139;1031524;3385
"71";1;1;17;47;1036733;1039982;3249
"73";1;3;39;48;1101761;1105871;4110
"75";1;3;19;49;1110933;1115729;4796
"77";1;3;23;50;1121687;1126103;4416
"79";1;2;98;51;1131355;1134187;2832
"80";1;4;84;52;1137475;1142195;4720
"81";1;2;82;53;1146836;1149603;2767
"82";1;2;10;54;1152856;1156186;3330
"84";1;4;92;55;1162013;1167927;5914
"85";1;4;36;56;1171430;1176019;4589
"87";1;2;38;57;1181377;1185193;3816
"89";1;4;8;58;1190480;1195343;4863
"91";1;2;54;59;1200818;1204393;3575
"92";1;4;20;60;1207872;1211876;4004
"94";1;4;48;61;1217005;1221958;4953
"95";1;4;56;62;1226124;1229983;3859
"96";1;4;44;63;1234478;1238475;3997
"97";1;4;24;64;1241305;1245366;4061
"99";1;4;40;65;1250287;1253749;3462
"101";1;2;2;66;1260462;1263965;3503
"103";1;4;72;67;1269842;1275673;5831
"104";1;4;100;68;1279300;1283682;4382
"105";1;4;16;69;1287162;1291931;4769
"107";1;4;52;70;1297012;1302081;5069
"108";1;2;62;71;1306112;1309206;3094
"109";1;2;78;72;1312280;1315989;3709
"110";1;4;96;73;1319836;1324222;4386
"111";1;4;60;74;1327407;1330880;3473
"112";1;4;12;75;1334017;1337663;3646
"114";1;2;26;76;1343802;1348254;4452
"116";1;2;86;77;1354588;1357729;3141
"117";1;2;34;78;1361729;1365145;3416
"119";1;4;68;79;1371897;1376628;4731
"120";1;4;80;80;1379586;1384428;4842
"121";1;2;94;81;1389028;1392094;3066
"122";1;2;66;82;1395279;1398927;3648
"123";1;2;18;83;1401672;1405060;3388
"125";1;2;58;84;1410384;1414693;4309
"126";1;2;6;85;1418267;1421201;2934
"128";1;4;4;86;1426619;1430476;3857
"130";1;4;28;87;1435557;1439693;4136
"132";1;2;22;88;1445485;1447967;2482
"134";1;4;76;89;1452977;1457367;4390
"135";1;2;74;90;1459997;1462875;2878
"136";1;4;88;91;1466970;1470958;3988
"137";1;2;46;92;1474892;1477916;3024
"138";1;4;64;93;1481379;1485674;4295
"139";1;2;42;94;1490168;1493791;3623
"140";1;2;30;95;1496804;1499982;3178
"142";1;2;70;96;1505078;1508890;3812
"143";1;2;50;97;1512411;1515798;3387
"144";1;2;90;98;1519126;1522639;3513
"145";1;4;32;99;1525394;1529581;4187
"147";1;2;14;100;1535819;1539006;3187
"910";2;2;97;1;3244852;3248844;3992
"1010";2;4;83;2;3251714;3256096;4382
"1110";2;2;81;3;3259008;3264952;5944
"1210";2;2;9;4;3268050;3272545;4495
"146";2;4;91;5;3278019;3283225;5206
"15";2;4;35;6;3285934;3290810;4876
"17";2;2;37;7;3296432;3302768;6336
"19";2;4;7;8;3309958;3316192;6234
"21";2;2;53;9;3323453;3327800;4347
"221";2;4;19;10;3330451;3338165;7714
"241";2;4;47;11;3344074;3348925;4851
"251";2;4;55;12;3351604;3358791;7187
"26";2;4;43;13;3361977;3368690;6713
"271";2;4;23;14;3371723;3377440;5717
"291";2;4;39;15;3382972;3389898;6926
"31";2;2;1;16;3396503;3401664;5161
"331";2;4;71;17;3407250;3413514;6264
"341";2;4;99;18;3416738;3424746;8008
"35";2;4;15;19;3428150;3433429;5279
"371";2;4;51;20;3441610;3446096;4486
"38";2;2;61;21;3448727;3453309;4582
"391";2;2;77;22;3459139;3463312;4173
"40";2;4;95;23;3466832;3473995;7163
"411";2;4;59;24;3477225;3481888;4663
"421";2;4;11;25;3484888;3490584;5696
"441";2;2;25;26;3496510;3502069;5559
"461";2;2;85;27;3508109;3511885;3776
"471";2;2;33;28;3515494;3520752;5258
"491";2;4;67;29;3528193;3534770;6577
"501";2;4;79;30;3537859;3543101;5242
"511";2;2;93;31;3580030;3586641;6611
"521";2;2;65;32;3589745;3594510;4765
"53";2;2;17;33;3598017;3602065;4048
"551";2;2;57;34;3607736;3612773;5037
"56";2;2;5;35;3615732;3621456;5724
"58";2;4;3;36;3628119;3634489;6370
"601";2;4;27;37;3641385;3649922;8537
"62";2;2;21;38;3656722;3665186;8464
"64";2;4;75;39;3672071;3679029;6958
"651";2;2;73;40;3681707;3688729;7022
"66";2;4;87;41;3695364;3700420;5056
"671";2;2;45;42;3704128;3707501;3373
"681";2;4;63;43;3712183;3717758;5575
"691";2;2;41;44;3721574;3726279;4705
"70";2;2;29;45;3729010;3734577;5567
"72";2;2;69;46;3740168;3747841;7673
"731";2;2;49;47;3751312;3755193;3881
"74";2;2;89;48;3812343;3816949;4606
"751";2;4;31;49;3820705;3826790;6085
"771";2;2;13;50;3833701;3837915;4214
"791";2;1;64;51;3877467;3882972;5505
"801";2;1;80;52;3885580;3893105;7525
"811";2;1;44;53;3895587;3900104;4517
"821";2;1;68;54;3903002;3908204;5202
"83";2;3;70;55;3911103;3917762;6659
"841";2;1;12;56;3920949;3926437;5488
"86";2;3;6;57;3932155;3937095;4940
"88";2;1;32;58;3942573;3949769;7196
"90";2;3;22;59;3955218;3961967;6749
"921";2;1;60;60;3968894;3973202;4308
"93";2;3;90;61;3975722;3984918;9196
"941";2;3;66;62;3987778;3994785;7007
"951";2;3;14;63;3997518;4004442;6924
"971";2;1;76;64;4009932;4014909;4977
"98";2;1;84;65;4017522;4023075;5553
"991";2;1;56;66;4025856;4031133;5277
"100";2;3;34;67;4033907;4041499;7592
"102";2;3;82;68;4047485;4055082;7597
"1031";2;3;94;69;4058156;4064565;6409
"1041";2;1;28;70;4067169;4071743;4574
"106";2;1;92;71;4077346;4082990;5644
"1071";2;1;16;72;4085750;4090131;4381
"1091";2;3;10;73;4097452;4105205;7753
"1111";2;1;96;74;4111510;4115009;3499
"1121";2;3;58;75;4117572;4124698;7126
"113";2;3;42;76;4127288;4134555;7267
"1141";2;3;50;77;4137199;4145154;7955
"115";2;3;74;78;4148914;4154662;5748
"1161";2;3;62;79;4157388;4164245;6857
"1171";2;3;98;80;4166857;4173095;6238
"118";2;3;54;81;4175709;4182222;6513
"1191";2;1;100;82;4185080;4189687;4607
"1201";2;1;52;83;4192299;4198219;5920
"1211";2;3;86;84;4200744;4207695;6951
"1221";2;3;38;85;4210885;4216168;5283
"124";2;1;88;86;4222141;4226876;4735
"1251";2;3;30;87;4229777;4237301;7524
"127";2;3;2;88;4244545;4251400;6855
"129";2;1;72;89;4258987;4267475;8488
"1301";2;3;46;90;4270495;4276907;6412
"131";2;1;4;91;4279547;4282749;3202
"133";2;1;8;92;4288832;4293991;5159
"1351";2;1;36;93;4300222;4305302;5080
"1371";2;1;48;94;4311134;4315623;4489
"1381";2;3;78;95;4318435;4325248;6813
"1391";2;3;26;96;4327915;4334512;6597
"141";2;3;18;97;4340211;4344964;4753
"1431";2;1;40;98;4351288;4354922;3634
"1451";2;1;20;99;4360119;4364413;4294
"1471";2;1;24;100;4371749;4377487;5738
"911";3;1;63;1;6088779;6091842;3063
"1011";3;1;79;2;6095007;6098320;3313
"1112";3;1;43;3;6100775;6105370;4595
"1212";3;1;67;4;6107745;6110653;2908
"1310";3;3;69;5;6112986;6118355;5369
"148";3;1;11;6;6120818;6125152;4334
"161";3;3;5;7;6130925;6136357;5432
"181";3;1;31;8;6143240;6146877;3637
"201";3;3;21;9;6153552;6158376;4824
"222";3;1;59;10;6163713;6167151;3438
"231";3;3;89;11;6169523;6174847;5324
"242";3;3;65;12;6177430;6183168;5738
"252";3;3;13;13;6186129;6190842;4713
"272";3;1;75;14;6197890;6204775;6885
"281";3;1;83;15;6207250;6209858;2608
"292";3;1;55;16;6212235;6215866;3631
"301";3;3;33;17;6218164;6222716;4552
"321";3;3;81;18;6227515;6231565;4050
"332";3;3;93;19;6234253;6241948;7695
"342";3;1;27;20;6244679;6248798;4119
"361";3;1;91;21;6254974;6259531;4557
"372";3;1;15;22;6261858;6264973;3115
"392";3;3;9;23;6270618;6273645;3027
"412";3;1;95;24;6279275;6285166;5891
"422";3;3;57;25;6288677;6292097;3420
"431";3;3;41;26;6294522;6297871;3349
"442";3;3;49;27;6300259;6306288;6029
"451";3;3;73;28;6308678;6315629;6951
"462";3;3;61;29;6318032;6323813;5781
"472";3;3;97;30;6326629;6330278;3649
"481";3;3;53;31;6333945;6339528;5583
"492";3;1;99;32;6342353;6345123;2770
"502";3;1;51;33;6347951;6351903;3952
"512";3;3;85;34;6355094;6360344;5250
"522";3;3;37;35;6363495;6368460;4965
"541";3;1;87;36;6374138;6377568;3430
"552";3;3;29;37;6380277;6384594;4317
"571";3;3;1;38;6390805;6395693;4888
"591";3;1;71;39;6401342;6404634;3292
"602";3;3;45;40;6407230;6410450;3220
"611";3;1;3;41;6413702;6416367;2665
"631";3;1;7;42;6421853;6425328;3475
"652";3;1;35;43;6431653;6435624;3971
"672";3;1;47;44;6440905;6445737;4832
"682";3;3;77;45;6448068;6452266;4198
"692";3;3;25;46;6454971;6460682;5711
"711";3;3;17;47;6469332;6474365;5033
"732";3;1;39;48;6533099;6537930;4831
"752";3;1;19;49;6545508;6550012;4504
"772";3;1;23;50;6615160;6618893;3733
"792";3;4;98;51;6623593;6627651;4058
"802";3;2;84;52;6630420;6634251;3831
"812";3;4;82;53;6637030;6640084;3054
"822";3;4;10;54;6642754;6647450;4696
"842";3;2;92;55;6654306;6657767;3461
"851";3;2;36;56;6660042;6663925;3883
"871";3;4;38;57;6670555;6675216;4661
"891";3;2;8;58;6681100;6684561;3461
"912";3;4;54;59;6689916;6694015;4099
"922";3;2;20;60;6697000;6700965;3965
"942";3;2;48;61;6706744;6710715;3971
"952";3;2;56;62;6713076;6715598;2522
"961";3;2;44;63;6718100;6720631;2531
"972";3;2;24;64;6723859;6726388;2529
"992";3;2;40;65;6731517;6733681;2164
"1012";3;4;2;66;6738739;6742245;3506
"1032";3;2;72;67;6747605;6752453;4848
"1042";3;2;100;68;6755837;6759805;3968
"1051";3;2;16;69;6762643;6766313;3670
"1072";3;2;52;70;6773187;6776208;3021
"1081";3;4;62;71;6779002;6781671;2669
"1092";3;4;78;72;6784081;6788368;4287
"1101";3;2;96;73;6791291;6793470;2179
"1113";3;2;60;74;6796711;6799270;2559
"1122";3;2;12;75;6801797;6803903;2106
"1142";3;4;26;76;6809279;6812281;3002
"1162";3;4;86;77;6818602;6822719;4117
"1172";3;4;34;78;6825558;6829752;4194
"1192";3;2;68;79;6835446;6838435;2989
"1202";3;2;80;80;6841587;6844347;2760
"1213";3;4;94;81;6847062;6849916;2854
"1222";3;4;66;82;6852487;6856018;3531
"1231";3;4;18;83;6858499;6860829;2330
"1252";3;4;58;84;6866202;6869981;3779
"1261";3;4;6;85;6872461;6875621;3160
"1281";3;2;4;86;6880330;6881909;1579
"1302";3;2;28;87;6886915;6890767;3852
"1321";3;4;22;88;6896481;6899316;2835
"1341";3;2;76;89;6904734;6909458;4724
"1352";3;4;74;90;6912364;6917716;5352
"1361";3;2;88;91;6920703;6923904;3201
"1372";3;4;46;92;6926809;6930682;3873
"1382";3;2;64;93;6933309;6938514;5205
"1392";3;4;42;94;6941435;6944026;2591
"1401";3;4;30;95;6946933;6950990;4057
"1421";3;4;70;96;6956256;6960556;4300
"1432";3;4;50;97;6964069;6968022;3953
"1441";3;4;90;98;6970891;6974860;3969
"1452";3;2;32;99;6977522;6980347;2825
"1472";3;4;14;100;6987215;6991430;4215
"913";4;4;97;1;9381453;9386873;5420
"1013";4;2;83;2;9391237;9394906;3669
"1114";4;4;81;3;9398314;9405272;6958
"1214";4;4;9;4;9408631;9414155;5524
"149";4;2;91;5;9420315;9424822;4507
"151";4;2;35;6;9427808;9431638;3830
"171";4;4;37;7;9437427;9442879;5452
"191";4;2;7;8;9448255;9452704;4449
"211";4;4;53;9;9460247;9464662;4415
"223";4;2;19;10;9467390;9472011;4621
"243";4;2;47;11;9478932;9482753;3821
"253";4;2;55;12;9485307;9489302;3995
"261";4;2;43;13;9491795;9497577;5782
"273";4;2;23;14;9500813;9504960;4147
"293";4;2;39;15;9511024;9515243;4219
"311";4;4;1;16;9520827;9529609;8782
"333";4;2;71;17;9537649;9542376;4727
"343";4;2;99;18;9545399;9551633;6234
"351";4;2;15;19;9554485;9559408;4923
"373";4;2;51;20;9565587;9571224;5637
"381";4;4;61;21;9574282;9581666;7384
"393";4;4;77;22;9584616;9590040;5424
"401";4;2;95;23;9592647;9598873;6226
"413";4;2;59;24;9601963;9609740;7777
"423";4;2;11;25;9612527;9616515;3988
"443";4;4;25;26;9622448;9630322;7874
"463";4;4;85;27;9635738;9641714;5976
"473";4;4;33;28;9644168;9648105;3937
"493";4;2;67;29;9655108;9660846;5738
"503";4;2;79;30;9663347;9666754;3407
"513";4;4;93;31;9669650;9677246;7596
"523";4;4;65;32;9681577;9687195;5618
"531";4;4;17;33;9689789;9696712;6923
"553";4;4;57;34;9702638;9711078;8440
"561";4;4;5;35;9714333;9724777;10444
"581";4;2;3;36;9730632;9735719;5087
"603";4;2;27;37;9741530;9748093;6563
"621";4;4;21;38;9754188;9760601;6413
"641";4;2;75;39;9765831;9774176;8345
"653";4;4;73;40;9777989;9783642;5653
"661";4;2;87;41;9787095;9791358;4263
"673";4;4;45;42;9793691;9799233;5542
"683";4;2;63;43;9801959;9807258;5299
"693";4;4;41;44;9809628;9814224;4596
"701";4;4;29;45;9816642;9823532;6890
"721";4;4;69;46;9829257;9844948;15691
"733";4;4;49;47;9847655;9857089;9434
"741";4;4;89;48;10004496;10009795;5299
"753";4;2;31;49;10013056;10019478;6422
"773";4;4;13;50;10024586;10030903;6317
"793";4;3;64;51;10037079;10045819;8740
"803";4;3;80;52;10049240;10056343;7103
"813";4;3;44;53;10059237;10067985;8748
"823";4;3;68;54;10071200;10078934;7734
"831";4;1;70;55;10081399;10089501;8102
"843";4;3;12;56;10093077;10100633;7556
"861";4;1;6;57;10106656;10112433;5777
"881";4;3;32;58;10118785;10126049;7264
"901";4;1;22;59;10131846;10137099;5253
"923";4;3;60;60;10143685;10150573;6888
"931";4;1;90;61;10153380;10158123;4743
"943";4;1;66;62;10161095;10167115;6020
"953";4;1;14;63;10170304;10177756;7452
"973";4;3;76;64;10183369;10190280;6911
"981";4;3;84;65;10194571;10203613;9042
"993";4;3;56;66;10208567;10214204;5637
"1001";4;1;34;67;10224795;10236270;11475
"1021";4;1;82;68;10242070;10247095;5025
"1033";4;1;94;69;10249749;10258569;8820
"1043";4;3;28;70;10263206;10273844;10638
"1061";4;3;92;71;10278793;10287394;8601
"1073";4;3;16;72;10290406;10297251;6845
"1093";4;1;10;73;10307101;10312184;5083
"1115";4;3;96;74;10350034;10357241;7207
"1123";4;1;58;75;10363105;10369516;6411
"1131";4;1;42;76;10372610;10376916;4306
"1143";4;1;50;77;10380475;10386482;6007
"1151";4;1;74;78;10390249;10394331;4082
"1163";4;1;62;79;10397081;10400823;3742
"1173";4;1;98;80;10405039;10409689;4650
"1181";4;1;54;81;10414953;10419564;4611
"1193";4;3;100;82;10456651;10463264;6613
"1203";4;3;52;83;10469602;10477097;7495
"1215";4;1;86;84;10481052;10488496;7444
"1223";4;1;38;85;10493472;10497896;4424
"1241";4;3;88;86;10503842;10510754;6912
"1253";4;1;30;87;10514484;10522228;7744
"1271";4;1;2;88;10565192;10570427;5235
"1291";4;3;72;89;10577035;10585242;8207
"1303";4;1;46;90;10588412;10593909;5497
"1311";4;3;4;91;10598588;10606775;8187
"1331";4;3;8;92;10613309;10619600;6291
"1353";4;3;36;93;10625512;10632732;7220
"1373";4;3;48;94;10638779;10645932;7153
"1383";4;1;78;95;10649124;10654182;5058
"1393";4;1;26;96;10657296;10661757;4461
"1411";4;1;18;97;10667194;10674556;7362
"1433";4;3;40;98;10679769;10685856;6087
"1453";4;3;20;99;10692939;10700455;7516
"1473";4;3;24;100;10705827;10716430;10603
"914";5;1;33;1;13626644;13630645;4001
"1116";5;3;91;2;13636948;13642653;5705
"1216";5;3;79;3;13645203;13654719;9516
"1312";5;1;25;4;13657354;13666393;9039
"152";5;3;11;5;13671990;13678960;6970
"172";5;1;41;6;13684485;13692009;7524
"182";5;1;29;7;13694524;13701226;6702
"202";5;3;83;8;13706663;13711292;4629
"212";5;3;59;9;13714062;13718958;4896
"224";5;3;67;10;13722094;13730508;8414
"232";5;1;57;11;13733743;13739874;6131
"244";5;1;17;12;13743244;13748532;5288
"262";5;1;53;13;13754506;13761673;7167
"274";5;1;85;14;13764017;13770423;6406
"282";5;1;13;15;13772740;13777773;5033
"302";5;1;81;16;13782934;13787056;4122
"312";5;3;87;17;13790820;13795072;4252
"322";5;1;45;18;13797646;13801197;3551
"334";5;1;1;19;13804691;13812338;7647
"352";5;3;55;20;13820077;13828238;8161
"362";5;1;73;21;13831393;13841587;10194
"374";5;3;43;22;13844573;13852570;7997
"382";5;1;77;23;13855284;13860786;5502
"394";5;1;89;24;13864226;13867986;3760
"402";5;1;49;25;13870549;13876069;5520
"414";5;3;27;26;13878507;13884677;6170
"432";5;1;9;27;13891150;13894994;3844
"452";5;3;99;28;13901087;13908626;7539
"464";5;1;97;29;13910944;13916776;5832
"474";5;3;75;30;13919866;13930367;10501
"482";5;1;21;31;13933038;13937901;4863
"504";5;1;65;32;13944052;13949083;5031
"514";5;3;63;33;13952605;13958166;5561
"524";5;3;71;34;13960607;13965549;4942
"532";5;3;3;35;13968738;13973749;5011
"554";5;1;5;36;13979768;13984649;4881
"572";5;3;7;37;13991805;13996698;4893
"592";5;3;35;38;14002884;14008481;5597
"612";5;3;47;39;14014660;14021339;6679
"622";5;1;37;40;14023833;14027697;3864
"642";5;3;19;41;14033875;14038847;4972
"662";5;1;69;42;14043882;14054988;11106
"674";5;3;39;43;14057389;14062296;4907
"694";5;1;61;44;14069000;14072270;3270
"702";5;1;93;45;14076323;14081720;5397
"712";5;3;51;46;14084729;14091062;6333
"722";5;3;15;47;14094308;14105461;11153
"742";5;3;95;48;14209737;14215290;5553
"754";5;3;31;49;14218427;14225915;7488
"774";5;3;23;50;14231794;14237590;5796
"794";5;4;36;51;14243986;14253298;9312
"814";5;2;38;52;14259123;14261489;2366
"832";5;4;28;53;14267149;14276105;8956
"852";5;4;68;54;14281823;14286180;4357
"862";5;2;18;55;14288788;14292896;4108
"882";5;4;8;56;14299184;14304921;5737
"902";5;4;20;57;14310708;14315837;5129
"924";5;4;40;58;14322035;14325828;3793
"944";5;4;60;59;14330896;14336244;5348
"954";5;4;56;60;14339012;14343536;4524
"962";5;2;30;61;14346305;14350969;4664
"982";5;2;14;62;14356525;14360252;3727
"1002";5;4;52;63;14365598;14370301;4703
"1014";5;4;80;64;14376593;14384926;8333
"1022";5;2;2;65;14387727;14391118;3391
"1044";5;2;98;66;14397109;14399892;2783
"1052";5;4;32;67;14402446;14407709;5263
"1074";5;2;62;68;14412848;14417642;4794
"1082";5;2;6;69;14420067;14422950;2883
"1102";5;4;92;70;14430400;14436166;5766
"1117";5;4;12;71;14439116;14445241;6125
"1132";5;4;16;72;14450698;14454857;4159
"1152";5;4;76;73;14461552;14467590;6038
"1164";5;2;78;74;14471087;14476790;5703
"1174";5;4;48;75;14481249;14487697;6448
"1182";5;2;74;76;14490201;14494580;4379
"1194";5;2;82;77;14497716;14504730;7014
"1204";5;4;84;78;14508137;14514055;5918
"1217";5;4;96;79;14517216;14521838;4622
"1224";5;2;50;80;14528193;14538679;10486
"1232";5;2;26;81;14541335;14545029;3694
"1254";5;4;64;82;14551233;14558511;7278
"1262";5;2;90;83;14561701;14567811;6110
"1272";5;2;46;84;14571630;14575369;3739
"1282";5;2;42;85;14578206;14581502;3296
"1292";5;2;58;86;14584612;14589261;4649
"1304";5;4;44;87;14595424;14600385;4961
"1313";5;2;54;88;14603032;14606218;3186
"1322";5;4;72;89;14610433;14619468;9035
"1332";5;2;66;90;14623159;14627476;4317
"1342";5;2;10;91;14634006;14637442;3436
"1362";5;4;88;92;14644027;14650250;6223
"1374";5;2;94;93;14653738;14657558;3820
"1384";5;2;86;94;14661106;14663991;2885
"1394";5;2;34;95;14671339;14678982;7643
"1412";5;4;4;96;14685532;14688957;3425
"1434";5;2;70;97;14698769;14704423;5654
"1442";5;4;100;98;14707627;14711706;4079
"1454";5;2;22;99;14718967;14722672;3705
"1474";5;4;24;100;14729280;14734389;5109
"915";6;2;97;1;16552108;16555828;3720
"1015";6;4;83;2;16558376;16562452;4076
"1118";6;2;81;3;16564923;16568760;3837
"1218";6;2;9;4;16571524;16574160;2636
"1410";6;4;91;5;16579487;16583043;3556
"153";6;4;35;6;16586403;16590976;4573
"173";6;2;37;7;16597400;16600709;3309
"192";6;4;7;8;16607378;16611109;3731
"213";6;2;53;9;16617106;16621067;3961
"225";6;4;19;10;16623805;16628842;5037
"245";6;4;47;11;16634620;16638524;3904
"254";6;4;55;12;16642484;16647316;4832
"263";6;4;43;13;16686287;16689456;3169
"275";6;4;23;14;16692782;16696506;3724
"294";6;4;39;15;16704155;16708330;4175
"313";6;2;1;16;16715143;16719388;4245
"335";6;4;71;17;16725585;16729996;4411
"344";6;4;99;18;16733149;16736638;3489
"353";6;4;15;19;16739775;16743271;3496
"375";6;4;51;20;16754563;16758445;3882
"383";6;2;61;21;16763497;16766645;3148
"395";6;2;77;22;16770038;16772928;2890
"403";6;4;95;23;16775615;16780469;4854
"415";6;4;59;24;16785327;16788036;2709
"424";6;4;11;25;16793732;16797844;4112
"444";6;2;25;26;16809086;16812276;3190
"465";6;2;85;27;16821087;16824585;3498
"475";6;2;33;28;16827846;16830734;2888
"494";6;4;67;29;16898073;16902267;4194
"505";6;4;79;30;16906012;16909650;3638
"515";6;2;93;31;16912984;16916258;3274
"525";6;2;65;32;16923181;16926466;3285
"533";6;2;17;33;16930427;16934082;3655
"555";6;2;57;34;16940571;16943465;2894
"562";6;2;5;35;16946729;16949557;2828
"582";6;4;3;36;16955600;16959840;4240
"604";6;4;27;37;16967101;16971157;4056
"623";6;2;21;38;16976701;16980506;3805
"643";6;4;75;39;16987627;16992147;4520
"654";6;2;73;40;16994913;16999839;4926
"663";6;4;87;41;17002227;17006438;4211
"675";6;2;45;42;17011557;17014163;2606
"684";6;4;63;43;17016836;17020129;3293
"695";6;2;41;44;17023480;17026013;2533
"703";6;2;29;45;17028766;17032220;3454
"723";6;2;69;46;17038227;17042753;4526
"734";6;2;49;47;17047145;17050070;2925
"743";6;2;89;48;17089766;17092152;2386
"755";6;4;31;49;17099584;17104210;4626
"78";6;2;13;51;17125603;17128467;2864
"804";6;1;64;52;17134878;17139225;4347
"815";6;1;80;53;17144185;17148766;4581
"824";6;1;44;54;17155601;17159616;4015
"844";6;1;68;56;17264588;17267831;3243
"853";6;3;70;57;17277777;17282597;4820
"863";6;1;12;58;17288710;17292672;3962
"883";6;3;6;59;17305554;17310313;4759
"903";6;1;32;60;17318447;17321996;3549
"925";6;3;22;61;17330144;17335337;5193
"945";6;1;60;62;17341651;17345162;3511
"955";6;3;90;63;17347346;17352778;5432
"963";6;3;66;64;17357212;17363194;5982
"974";6;3;14;65;17371818;17376886;5068
"994";6;1;76;66;17383456;17387127;3671
"1003";6;1;84;67;17392874;17397385;4511
"1016";6;1;56;68;17403703;17407043;3340
"1023";6;3;34;69;17414313;17419459;5146
"1045";6;3;82;70;17425160;17430934;5774
"1053";6;3;94;71;17436203;17442609;6406
"1062";6;1;28;72;17444931;17449725;4794
"1083";6;1;92;73;17458315;17463499;5184
"1094";6;1;16;74;17470339;17474849;4510
"1119";6;3;10;75;17483743;17488832;5089
"1133";6;1;96;76;17496546;17499531;2985
"1144";6;3;58;77;17505190;17510448;5258
"1153";6;3;42;78;17517379;17522831;5452
"1165";6;3;50;79;17527305;17532322;5017
"1175";6;3;74;80;17537479;17542788;5309
"1183";6;3;62;81;17547061;17551763;4702
"1195";6;3;98;82;17559274;17562979;3705
"1205";6;3;54;83;17568425;17574304;5879
"1219";6;1;100;84;17578789;17582887;4098
"1225";6;1;52;85;17589814;17594486;4672
"1233";6;3;86;86;17597764;17602645;4881
"1242";6;3;38;87;17607876;17612477;4601
"1263";6;1;88;88;17618539;17624452;5913
"1273";6;3;30;89;17629577;17634093;4516
"1293";6;3;2;90;17643673;17649268;5595
"1314";6;1;72;91;17658184;17663650;5466
"1323";6;3;46;92;17666175;17671992;5817
"1333";6;1;4;93;17677276;17681758;4482
"1354";6;1;8;94;17687160;17692333;5173
"1375";6;1;36;95;17698411;17702383;3972
"1395";6;1;48;96;17707690;17713032;5342
"1402";6;3;78;97;17715997;17720765;4768
"1413";6;3;26;98;17723464;17728765;5301
"1435";6;3;18;99;17737550;17742381;4831
"1455";6;1;40;100;17752664;17758222;5558
"1475";6;1;20;101;17767894;17772222;4328
"1491";6;1;24;102;17779925;17783671;3746
"916";7;1;63;1;26095767;26102458;6691
"1017";7;1;79;2;26140235;26145107;4872
"1120";7;1;43;3;26149236;26158848;9612
"1220";7;1;67;4;26161652;26168614;6962
"1315";7;3;69;5;26171454;26179805;8351
"1414";7;1;11;6;26182961;26188580;5619
"162";7;3;5;7;26195349;26202471;7122
"183";7;1;31;8;26208615;26215613;6998
"203";7;3;21;9;26221930;26233803;11873
"226";7;1;59;10;26244092;26250870;6778
"233";7;3;89;11;26254052;26263219;9167
"246";7;3;65;12;26266834;26277277;10443
"255";7;3;13;13;26279669;26289468;9799
"276";7;1;75;14;26295580;26302426;6846
"283";7;1;83;15;26305528;26310042;4514
"295";7;1;55;16;26314101;26320559;6458
"303";7;3;33;17;26323863;26332350;8487
"323";7;3;81;18;26337520;26344591;7071
"336";7;3;93;19;26350758;26357799;7041
"345";7;1;27;20;26360579;26366615;6036
"363";7;1;91;21;26371690;26377165;5475
"376";7;1;15;22;26379669;26385448;5779
"396";7;3;9;23;26391073;26397331;6258
"416";7;1;95;24;26402219;26407739;5520
"425";7;3;57;25;26410033;26416580;6547
"433";7;3;41;26;26419948;26431747;11799
"445";7;3;49;27;26434597;26444012;9415
"453";7;3;73;28;26446492;26456279;9787
"466";7;3;61;29;26458650;26467887;9237
"476";7;3;97;30;26470366;26484553;14187
"483";7;3;53;31;26487190;26494544;7354
"495";7;1;99;32;26496768;26501635;4867
"506";7;1;51;33;26504157;26508968;4811
"516";7;3;85;34;26511615;26520810;9195
"526";7;3;37;35;26523137;26531143;8006
"542";7;1;87;36;26537046;26542034;4988
"556";7;3;29;37;26544433;26555525;11092
"573";7;3;1;38;26561513;26570100;8587
"593";7;1;71;39;26575643;26581549;5906
"605";7;3;45;40;26585461;26592066;6605
"613";7;1;3;41;26594685;26601607;6922
"632";7;1;7;42;26607581;26612457;4876
"655";7;1;35;43;26618978;26625131;6153
"676";7;1;47;44;26631376;26638322;6946
"685";7;3;77;45;26640629;26649672;9043
"696";7;3;25;46;26652438;26662013;9575
"713";7;3;17;47;26670431;26676946;6515
"735";7;1;39;48;26725496;26729980;4484
"756";7;1;19;49;26735727;26741788;6061
"775";7;1;23;50;26748368;26753387;5019
"795";7;4;98;51;26758704;26765062;6358
"805";7;2;84;52;26769793;26776620;6827
"816";7;4;82;53;26781617;26786378;4761
"825";7;4;10;54;26789661;26797711;8050
"845";7;2;92;55;26804227;26808969;4742
"854";7;2;36;56;26811757;26816410;4653
"872";7;4;38;57;26823595;26829302;5707
"892";7;2;8;58;26836979;26842201;5222
"917";7;4;54;59;26848633;26854284;5651
"926";7;2;20;60;26889936;26893983;4047
"946";7;2;48;61;26899722;26905807;6085
"956";7;2;56;62;26908750;26912849;4099
"964";7;2;44;63;26915164;26919732;4568
"975";7;2;24;64;26922150;26926865;4715
"995";7;2;40;65;26932705;26935973;3268
"1018";7;4;2;66;26941201;26946139;4938
"1034";7;2;72;67;26951816;26960039;8223
"1046";7;2;100;68;26963248;26967363;4115
"1054";7;2;16;69;26972964;26978605;5641
"1075";7;2;52;70;26985114;26990346;5232
"1084";7;4;62;71;26992853;26997545;4692
"1095";7;4;78;72;27000285;27006303;6018
"1103";7;2;96;73;27009067;27012270;3203
"11110";7;2;60;74;27014901;27018469;3568
"1124";7;2;12;75;27021420;27025278;3858
"1145";7;4;26;76;27030406;27035327;4921
"1166";7;4;86;77;27040566;27045561;4995
"1176";7;4;34;78;27048905;27056643;7738
"1196";7;2;68;79;27063812;27070801;6989
"1206";7;2;80;80;27073163;27077826;4663
"12110";7;4;94;81;27080260;27085409;5149
"1226";7;4;66;82;27088209;27093708;5499
"1234";7;4;18;83;27096208;27101925;5717
"1255";7;4;58;84;27107652;27114741;7089
"1264";7;4;6;85;27117278;27123999;6721
"1283";7;2;4;86;27129443;27132749;3306
"1305";7;2;28;87;27137358;27142349;4991
"1324";7;4;22;88;27151586;27159765;8179
"1343";7;2;76;89;27166207;27177497;11290
"1355";7;4;74;90;27179729;27185714;5985
"1363";7;2;88;91;27189100;27193847;4747
"1376";7;4;46;92;27197341;27204605;7264
"1385";7;2;64;93;27207516;27213238;5722
"1396";7;4;42;94;27216347;27221062;4715
"1403";7;4;30;95;27223864;27228820;4956
"1422";7;4;70;96;27234573;27241112;6539
"1436";7;4;50;97;27244771;27251403;6632
"1443";7;4;90;98;27253889;27260861;6972
"1456";7;2;32;99;27263977;27269902;5925
"1476";7;4;14;100;27276702;27283060;6358
"918";8;4;97;1;1042364;1048810;6446
"1019";8;2;83;2;1051971;1056810;4839
"1125";8;4;81;3;1059553;1066701;7148
"1227";8;4;9;4;1069337;1075559;6222
"1415";8;2;91;5;1080642;1085367;4725
"154";8;2;35;6;1088201;1093150;4949
"174";8;4;37;7;1098975;1106933;7958
"193";8;2;7;8;1112300;1117258;4958
"214";8;4;53;9;1124509;1132691;8182
"227";8;2;19;10;1134693;1140682;5989
"247";8;2;47;11;1145590;1151690;6100
"256";8;2;55;12;1153993;1160489;6496
"264";8;2;43;13;1163176;1169181;6005
"277";8;2;23;14;1171938;1177439;5501
"296";8;2;39;15;1182480;1189389;6909
"314";8;4;1;16;1194653;1201896;7243
"337";8;2;71;17;1208451;1214146;5695
"346";8;2;99;18;1216410;1222237;5827
"354";8;2;15;19;1225048;1231345;6297
"377";8;2;51;20;1236895;1242712;5817
"384";8;4;61;21;1245302;1252070;6768
"397";8;4;77;22;1255382;1262211;6829
"404";8;2;95;23;1265299;1271644;6345
"417";8;2;59;24;1274392;1281302;6910
"426";8;2;11;25;1284858;1290952;6094
"446";8;4;25;26;1297164;1304392;7228
"467";8;4;85;27;1310487;1317325;6838
"477";8;4;33;28;1319876;1325508;5632
"496";8;2;67;29;1331259;1337149;5890
"507";8;2;79;30;1339931;1344958;5027
"517";8;4;93;31;1347150;1356024;8874
"527";8;4;65;32;1358692;1365282;6590
"534";8;4;17;33;1367789;1375898;8109
"557";8;4;57;34;1381730;1387981;6251
"563";8;4;5;35;1390812;1398823;8011
"583";8;2;3;36;1404246;1410056;5810
"606";8;2;27;37;1415712;1421839;6127
"624";8;4;21;38;1426929;1435763;8834
"644";8;2;75;39;1440729;1448754;8025
"656";8;4;73;40;1451597;1458954;7357
"664";8;2;87;41;1461785;1465604;3819
"677";8;4;45;42;1468215;1474370;6155
"686";8;2;63;43;1476821;1482453;5632
"697";8;4;41;44;1484868;1492261;7393
"704";8;4;29;45;1494736;1501044;6308
"724";8;4;69;46;1507177;1519143;11966
"736";8;4;49;47;1521859;1529409;7550
"744";8;4;89;48;1532044;1538343;6299
"757";8;2;31;49;1547809;1554017;6208
"776";8;4;13;50;1559542;1568000;8458
"796";8;3;64;51;1572928;1580366;7438
"806";8;3;80;52;1582761;1594324;11563
"817";8;3;44;53;1596673;1603482;6809
"826";8;3;68;54;1606591;1613582;6991
"833";8;1;70;55;1616235;1622281;6046
"846";8;3;12;56;1624710;1634314;9604
"864";8;1;6;57;1639383;1646580;7197
"884";8;3;32;58;1652117;1658296;6179
"904";8;1;22;59;1663438;1668663;5225
"927";8;3;60;60;1674110;1678746;4636
"932";8;1;90;61;1681565;1689521;7956
"947";8;1;66;62;1692631;1700745;8114
"957";8;1;14;63;1740235;1744910;4675
"976";8;3;76;64;1750155;1760010;9855
"983";8;3;84;65;1763266;1770259;6993
"996";8;3;56;66;1773651;1781742;8091
"1004";8;1;34;67;1785225;1792017;6792
"1024";8;1;82;68;1800407;1806691;6284
"1035";8;1;94;69;1810289;1815841;5552
"1047";8;3;28;70;1818660;1827982;9322
"1063";8;3;92;71;1834911;1842965;8054
"1076";8;3;16;72;1847053;1852857;5804
"1096";8;1;10;73;1889312;1895480;6168
"11111";8;3;96;74;1902909;1910112;7203
"1126";8;1;58;75;1912727;1918779;6052
"1134";8;1;42;76;1921542;1927037;5495
"1146";8;1;50;77;1929660;1938886;9226
"1154";8;1;74;78;1941917;1947428;5511
"1167";8;1;62;79;1949893;1954119;4226
"1177";8;1;98;80;1956926;1961352;4426
"1184";8;1;54;81;1963857;1969994;6137
"1197";8;3;100;82;1973033;1979760;6727
"1207";8;3;52;83;1982502;1989110;6608
"12111";8;1;86;84;1991644;1995651;4007
"1228";8;1;38;85;1998181;2002876;4695
"1243";8;3;88;86;2008770;2016209;7439
"1256";8;1;30;87;2019442;2026800;7358
"1274";8;1;2;88;2032229;2040550;8321
"1294";8;3;72;89;2046284;2054424;8140
"1306";8;1;46;90;2057308;2062566;5258
"1316";8;3;4;91;2065715;2071148;5433
"1334";8;3;8;92;2076593;2083673;7080
"1356";8;3;36;93;2089124;2097389;8265
"1377";8;3;48;94;2103546;2110189;6643
"1386";8;1;78;95;2112883;2120055;7172
"1397";8;1;26;96;2122771;2128113;5342
"1416";8;1;18;97;2133996;2140654;6658
"1437";8;3;40;98;2145448;2153146;7698
"1457";8;3;20;99;2158748;2166687;7939
"1477";8;3;24;100;2173170;2180303;7133
"919";9;3;63;1;3683477;3691152;7675
"1020";9;3;79;2;3693952;3703726;9774
"1127";9;3;43;3;3706288;3713267;6979
"1229";9;3;67;4;3717938;3724092;6154
"1317";9;1;69;5;3727208;3733267;6059
"1417";9;3;11;6;3736979;3741791;4812
"163";9;1;5;7;3748402;3755433;7031
"184";9;3;31;8;3764971;3771574;6603
"204";9;1;21;9;3777163;3781765;4602
"228";9;3;59;10;3795248;3802939;7691
"234";9;1;89;11;3806894;3810830;3936
"248";9;1;65;12;3816484;3821814;5330
"257";9;1;13;13;3826037;3832947;6910
"278";9;3;75;14;3838346;3847229;8883
"284";9;3;83;15;3850334;3854179;3845
"297";9;3;55;16;3857599;3863912;6313
"304";9;1;33;17;3866481;3869962;3481
"324";9;1;81;18;3874768;3878895;4127
"338";9;1;93;19;3883226;3888578;5352
"347";9;3;27;20;3892001;3897444;5443
"364";9;3;91;21;3902570;3911419;8849
"378";9;3;15;22;3915509;3920410;4901
"398";9;1;9;23;3926706;3931143;4437
"418";9;3;95;24;3936977;3943526;6549
"427";9;1;57;25;3946486;3949959;3473
"434";9;1;41;26;3953982;3958634;4652
"447";9;1;49;27;4004338;4010382;6044
"454";9;1;73;28;4014841;4022273;7432
"468";9;1;61;29;4025956;4029423;3467
"478";9;1;97;30;4033364;4037589;4225
"484";9;1;53;31;4041413;4045939;4526
"497";9;3;99;32;4052119;4058455;6336
"508";9;3;51;33;4064381;4069713;5332
"518";9;1;85;34;4072912;4077646;4734
"528";9;1;37;35;4080948;4085196;4248
"543";9;3;87;36;4090553;4095187;4634
"558";9;1;29;37;4101703;4106670;4967
"574";9;1;1;38;4113808;4118953;5145
"594";9;3;71;39;4124927;4131419;6492
"607";9;1;45;40;4136622;4139736;3114
"614";9;3;3;41;4142725;4147852;5127
"633";9;3;7;42;4157129;4162760;5631
"657";9;3;35;43;4170175;4176301;6126
"678";9;3;47;44;4183530;4188450;4920
"687";9;1;77;45;4191799;4196767;4968
"698";9;1;25;46;4200079;4207791;7712
"714";9;1;17;47;4213896;4217766;3870
"737";9;3;39;48;4224568;4229757;5189
"758";9;3;19;49;4236454;4241107;4653
"777";9;3;23;50;4246976;4251365;4389
"797";9;2;98;51;4322871;4327262;4391
"807";9;4;84;52;4330353;4338929;8576
"818";9;2;82;53;4341924;4346278;4354
"827";9;2;10;54;4348943;4353370;4427
"847";9;4;92;55;4360716;4366586;5870
"855";9;4;36;56;4368923;4375586;6663
"873";9;2;38;57;4384085;4386735;2650
"893";9;4;8;58;4392021;4396085;4064
"9110";9;2;54;59;4402234;4404668;2434
"928";9;4;20;60;4407073;4410626;3553
"948";9;4;48;61;4415929;4420376;4447
"958";9;4;56;62;4423031;4427442;4411
"965";9;4;44;63;4431934;4436675;4741
"977";9;4;24;64;4441261;4445958;4697
"997";9;4;40;65;4456860;4460291;3431
"10110";9;2;2;66;4465219;4469549;4330
"1036";9;4;72;67;4478043;4488106;10063
"1048";9;4;100;68;4492357;4496023;3666
"1055";9;4;16;69;4498713;4503289;4576
"1077";9;4;52;70;4510004;4516689;6685
"1085";9;2;62;71;4519964;4523322;3358
"1097";9;2;78;72;4527705;4531755;4050
"1104";9;4;96;73;4535630;4541155;5525
"11112";9;4;60;74;4544612;4548796;4184
"1128";9;4;12;75;4551871;4558662;6791
"1147";9;2;26;76;4565727;4570645;4918
"1168";9;2;86;77;4577173;4580178;3005
"1178";9;2;34;78;4583087;4586253;3166
"1198";9;4;68;79;4591638;4594844;3206
"1208";9;4;80;80;4598781;4602977;4196
"12112";9;2;94;81;4608752;4613544;4792
"12210";9;2;66;82;4619249;4623052;3803
"1235";9;2;18;83;4626953;4631735;4782
"1257";9;2;58;84;4638391;4643493;5102
"1265";9;2;6;85;4648073;4651476;3403
"1284";9;4;4;86;4658376;4661884;3508
"1307";9;4;28;87;4713428;4720226;6798
"1325";9;2;22;88;4726443;4728951;2508
"1344";9;4;76;89;4734285;4739976;5691
"1357";9;2;74;90;4743163;4746742;3579
"1364";9;4;88;91;4749936;4755441;5505
"1378";9;2;46;92;4758057;4761308;3251
"1387";9;4;64;93;4764641;4772833;8192
"1398";9;2;42;94;4775749;4779466;3717
"1404";9;2;30;95;4782414;4787207;4793
"1423";9;2;70;96;4794219;4799357;5138
"1438";9;2;50;97;4802164;4806690;4526
"1444";9;2;90;98;4811545;4815606;4061
"1458";9;4;32;99;4819982;4824206;4224
"1478";9;2;14;100;4830600;4834197;3597
"920";10;2;97;1;5999085;6001614;2529
"1025";10;4;83;2;6006226;6009908;3682
"1129";10;2;81;3;6012757;6014908;2151
"1230";10;2;9;4;6018340;6020680;2340
"1418";10;4;91;5;6027024;6030996;3972
"155";10;4;35;6;6034012;6037557;3545
"175";10;2;37;7;6043668;6047190;3522
"194";10;4;7;8;6053828;6057453;3625
"215";10;2;53;9;6064413;6067431;3018
"229";10;4;19;10;6070225;6073136;2911
"249";10;4;47;11;6078362;6081944;3582
"258";10;4;55;12;6086061;6089327;3266
"265";10;4;43;13;6092065;6095660;3595
"279";10;4;23;14;6098243;6100825;2582
"298";10;4;39;15;6105896;6109434;3538
"315";10;2;1;16;6115813;6118810;2997
"339";10;4;71;17;6125060;6128444;3384
"348";10;4;99;18;6132759;6136228;3469
"355";10;4;15;19;6139782;6143892;4110
"379";10;4;51;20;6148964;6151817;2853
"385";10;2;61;21;6154637;6156477;1840
"399";10;2;77;22;6158982;6161100;2118
"405";10;4;95;23;6163637;6166983;3346
"419";10;4;59;24;6170014;6172916;2902
"428";10;4;11;25;6175523;6178599;3076
"448";10;2;25;26;6184073;6187399;3326
"469";10;2;85;27;6192834;6195232;2398
"479";10;2;33;28;6198495;6200432;1937
"498";10;4;67;29;6206112;6209131;3019
"509";10;4;79;30;6212111;6216081;3970
"519";10;2;93;31;6218540;6221770;3230
"529";10;2;65;32;6224806;6227794;2988
"535";10;2;17;33;6230926;6234259;3333
"559";10;2;57;34;6239483;6241113;1630
"564";10;2;5;35;6243302;6245355;2053
"584";10;4;3;36;6250397;6254076;3679
"608";10;4;27;37;6260069;6264013;3944
"625";10;2;21;38;6269536;6271910;2374
"645";10;4;75;39;6277019;6279962;2943
"658";10;2;73;40;6283143;6285520;2377
"665";10;4;87;41;6287991;6291428;3437
"679";10;2;45;42;6294105;6296311;2206
"688";10;4;63;43;6299278;6302136;2858
"699";10;2;41;44;6305110;6306903;1793
"705";10;2;29;45;6309988;6312461;2473
"725";10;2;69;46;6317214;6319494;2280
"738";10;2;49;47;6321917;6324377;2460
"745";10;2;89;48;6327080;6328960;1880
"759";10;4;31;49;6331845;6336677;4832
"778";10;2;13;50;6341893;6343802;1909
"798";10;1;64;51;6349160;6351643;2483
"808";10;1;80;52;6354438;6357634;3196
"819";10;1;44;53;6360345;6362934;2589
"828";10;1;68;54;6365626;6368924;3298
"834";10;3;70;55;6371840;6375659;3819
"848";10;1;12;56;6378149;6381150;3001
"865";10;3;6;57;6385878;6389783;3905
"885";10;1;32;58;6394955;6397941;2986
"905";10;3;22;59;6403188;6406382;3194
"929";10;1;60;60;6413435;6416232;2797
"933";10;3;90;61;6419755;6423782;4027
"949";10;3;66;62;6427011;6431082;4071
"959";10;3;14;63;6434116;6437781;3665
"978";10;1;76;64;6442930;6444773;1843
"984";10;1;84;65;6447417;6449739;2322
"998";10;1;56;66;6452313;6454047;1734
"1005";10;3;34;67;6456429;6459397;2968
"1026";10;3;82;68;6464211;6467514;3303
"1037";10;3;94;69;6470807;6474803;3996
"1049";10;1;28;70;6477557;6480613;3056
"1064";10;1;92;71;6485772;6488708;2936
"1078";10;1;16;72;6491431;6494005;2574
"1098";10;3;10;73;6499294;6502262;2968
"11113";10;1;96;74;6507101;6510174;3073
"11210";10;3;58;75;6516021;6519503;3482
"1135";10;3;42;76;6522240;6527261;5021
"1148";10;3;50;77;6530476;6534545;4069
"1155";10;3;74;78;6537506;6541215;3709
"1169";10;3;62;79;6545788;6548302;2514
"1179";10;3;98;80;6550638;6553510;2872
"1185";10;3;54;81;6556340;6559419;3079
"1199";10;1;100;82;6562016;6564569;2553
"1209";10;1;52;83;6567429;6570505;3076
"12113";10;3;86;84;6573404;6577442;4038
"12211";10;3;38;85;6580245;6583617;3372
"1244";10;1;88;86;6588595;6591154;2559
"1258";10;3;30;87;6593798;6597117;3319
"1275";10;3;2;88;6601791;6605800;4009
"1295";10;1;72;89;6611066;6614117;3051
"1308";10;3;46;90;6617151;6621000;3849
"1318";10;1;4;91;6623313;6628421;5108
"1335";10;1;8;92;6633364;6636257;2893
"1358";10;1;36;93;6642823;6645424;2601
"1379";10;1;48;94;6650945;6653622;2677
"1388";10;3;78;95;6656340;6660024;3684
"1399";10;3;26;96;6662627;6666544;3917
"1419";10;3;18;97;6674369;6676714;2345
"1439";10;1;40;98;6681289;6684056;2767
"1459";10;1;20;99;6688526;6690833;2307
"1479";10;1;24;100;6695724;6698155;2431
"930";11;1;63;1;9154300;9159419;5119
"1027";11;1;79;2;9165905;9170277;4372
"1130";11;1;43;3;9173773;9178835;5062
"1236";11;1;67;4;9181119;9186915;5796
"1319";11;3;69;5;9189914;9198201;8287
"1420";11;1;11;6;9201179;9207076;5897
"164";11;3;5;7;9214581;9221325;6744
"185";11;1;31;8;9226986;9232005;5019
"205";11;3;21;9;9239566;9248808;9242
"2210";11;1;59;10;9255455;9262057;6602
"235";11;3;89;11;9264444;9270767;6323
"2410";11;3;65;12;9274340;9280390;6050
"259";11;3;13;13;9283261;9290081;6820
"2710";11;1;75;14;9296302;9302922;6620
"285";11;1;83;15;9305867;9310394;4527
"299";11;1;55;16;9313451;9318147;4696
"305";11;3;33;17;9320960;9328396;7436
"325";11;3;81;18;9334462;9341717;7255
"3310";11;3;93;19;9344171;9350750;6579
"349";11;1;27;20;9353874;9358895;5021
"365";11;1;91;21;9364415;9368028;3613
"3710";11;1;15;22;9371224;9375678;4454
"3910";11;3;9;23;9382631;9388911;6280
"4110";11;1;95;24;9395511;9400477;4966
"429";11;3;57;25;9402751;9408543;5792
"435";11;3;41;26;9410871;9416810;5939
"449";11;3;49;27;9419226;9426618;7392
"455";11;3;73;28;9429030;9436234;7204
"4610";11;3;61;29;9438711;9444428;5717
"4710";11;3;97;30;9447025;9454692;7667
"485";11;3;53;31;9457594;9464083;6489
"499";11;1;99;32;9466446;9472166;5720
"5010";11;1;51;33;9475445;9481366;5921
"5110";11;3;85;34;9483749;9489774;6025
"5210";11;3;37;35;9492644;9502232;9588
"544";11;1;87;36;9508333;9512856;4523
"5510";11;3;29;37;9515323;9522448;7125
"575";11;3;1;38;9528323;9535642;7319
"595";11;1;71;39;9541374;9546497;5123
"609";11;3;45;40;9548903;9554595;5692
"615";11;1;3;41;9557532;9563047;5515
"634";11;1;7;42;9569085;9573054;3969
"659";11;1;35;43;9580632;9585573;4941
"6710";11;1;47;44;9590966;9594737;3771
"689";11;3;77;45;9598346;9604518;6172
"6910";11;3;25;46;9607114;9615145;8031
"715";11;3;17;47;9621745;9627256;5511
"739";11;1;39;48;9632791;9638152;5361
"7510";11;1;19;49;9644461;9649301;4840
"779";11;1;23;50;9654866;9659307;4441
"799";11;4;98;51;9664512;9668751;4239
"809";11;2;84;52;9671553;9678184;6631
"8110";11;4;82;53;9681314;9686242;4928
"829";11;4;10;54;9689050;9696425;7375
"849";11;2;92;55;9702351;9709054;6703
"856";11;2;36;56;9712254;9716974;4720
"874";11;4;38;57;9722698;9727724;5026
"894";11;2;8;58;9733753;9739040;5287
"9111";11;4;54;59;9744765;9750173;5408
"9210";11;2;20;60;9753318;9757281;3963
"9410";11;2;48;61;9762343;9766809;4466
"9510";11;2;56;62;9769126;9773898;4772
"966";11;2;44;63;9776272;9780388;4116
"979";11;2;24;64;9783227;9787138;3911
"999";11;2;40;65;9792245;9796271;4026
"10111";11;4;2;66;9801810;9808380;6570
"1038";11;2;72;67;9815363;9822387;7024
"10410";11;2;100;68;9825054;9829422;4368
"1056";11;2;16;69;9832409;9837145;4736
"1079";11;2;52;70;9842649;9848286;5637
"1086";11;4;62;71;9851030;9856303;5273
"1099";11;4;78;72;9859108;9866961;7853
"1105";11;2;96;73;9869419;9872869;3450
"11114";11;2;60;74;9875420;9879361;3941
"11211";11;2;12;75;9881829;9886329;4500
"1149";11;4;26;76;9892290;9899984;7694
"11610";11;4;86;77;9906374;9912619;6245
"11710";11;4;34;78;9915655;9921052;5397
"11910";11;2;68;79;9927054;9932683;5629
"12010";11;2;80;80;9936067;9941541;5474
"12114";11;4;94;81;9943881;9949899;6018
"12212";11;4;66;82;9952217;9958882;6665
"1237";11;4;18;83;9961465;9967949;6484
"1259";11;4;58;84;9973467;9979087;5620
"1266";11;4;6;85;9981566;9988264;6698
"1285";11;2;4;86;9993967;9997422;3455
"1309";11;2;28;87;10002992;10009680;6688
"1326";11;4;22;88;10018763;10024035;5272
"1345";11;2;76;89;10029961;10034004;4043
"1359";11;4;74;90;10037136;10042421;5285
"1365";11;2;88;91;10045221;10052965;7744
"13710";11;4;46;92;10055450;10062061;6611
"1389";11;2;64;93;10064533;10069478;4945
"13910";11;4;42;94;10072004;10079375;7371
"1405";11;4;30;95;10083123;10090261;7138
"1424";11;4;70;96;10096736;10101664;4928
"14310";11;4;50;97;10104329;10110835;6506
"1445";11;4;90;98;10113463;10120202;6739
"14510";11;2;32;99;10122868;10127273;4405
"14710";11;4;14;100;10133696;10139101;5405
"934";12;4;97;1;12295129;12300640;5511
"1028";12;2;83;2;12307820;12311206;3386
"1136";12;4;81;3;12345986;12350663;4677
"1238";12;4;9;4;12356052;12359604;3552
"1425";12;2;91;5;12365867;12369929;4062
"156";12;2;35;6;12376349;12379754;3405
"176";12;4;37;7;12387492;12391903;4411
"195";12;2;7;8;12396767;12400306;3539
"216";12;4;53;9;12406728;12410528;3800
"2211";12;2;19;10;12413372;12416553;3181
"2411";12;2;47;11;12421494;12423910;2416
"2510";12;2;55;12;12431703;12434677;2974
"266";12;2;43;13;12437104;12440777;3673
"2711";12;2;23;14;12442984;12445709;2725
"2910";12;2;39;15;12451649;12455043;3394
"316";12;4;1;16;12461682;12466927;5245
"3311";12;2;71;17;12472487;12475692;3205
"3410";12;2;99;18;12478185;12481663;3478
"356";12;2;15;19;12486671;12489866;3195
"3711";12;2;51;20;12496907;12499957;3050
"386";12;4;61;21;12503015;12507904;4889
"3911";12;4;77;22;12514461;12518890;4429
"406";12;2;95;23;12521334;12524990;3656
"4111";12;2;59;24;12527861;12530531;2670
"436";12;2;11;26;12666437;12669293;2856
"456";12;4;25;27;12674823;12679093;4270
"4711";12;4;85;28;12687497;12692151;4654
"486";12;4;33;29;12695406;12699917;4511
"5011";12;2;67;30;12704641;12708527;3886
"5111";12;2;79;31;12711738;12714687;2949
"5211";12;4;93;32;12717355;12722383;5028
"536";12;4;65;33;12726229;12730664;4435
"545";12;4;17;34;12734226;12737841;3615
"565";12;4;57;35;12744401;12748025;3624
"576";12;4;5;36;12751012;12754890;3878
"596";12;2;3;37;12762324;12765398;3074
"616";12;2;27;38;12771387;12775414;4027
"635";12;4;21;39;12781157;12785132;3975
"6510";12;2;75;40;12790372;12794589;4217
"666";12;4;73;41;12797415;12801517;4102
"6711";12;2;87;42;12805248;12807725;2477
"6810";12;4;45;43;12810256;12814798;4542
"6911";12;2;63;44;12818274;12821118;2844
"706";12;4;41;45;12823818;12827696;3878
"716";12;4;29;46;12831881;12836935;5054
"746";12;4;69;48;12969044;12974352;5308
"7511";12;4;49;49;12977740;12982149;4409
"76";12;4;89;50;12985690;12989082;3392
"7710";12;2;31;51;12994537;12998498;3961
"7910";12;4;13;52;13003861;13008114;4253
"8111";12;3;64;53;13014178;13019997;5819
"8210";12;3;80;54;13023993;13029644;5651
"835";12;3;44;55;13033786;13039080;5294
"8410";12;3;68;56;13042881;13047606;4725
"857";12;1;70;57;13051793;13055221;3428
"866";12;3;12;58;13058776;13063613;4837
"886";12;1;6;59;13070261;13074229;3968
"906";12;3;32;60;13079116;13083296;4180
"9211";12;1;22;61;13089854;13093128;3274
"9411";12;3;60;62;13100696;13105828;5132
"9511";12;1;90;63;13109352;13113035;3683
"967";12;1;66;64;13115978;13119939;3961
"9710";12;1;14;65;13125116;13128518;3402
"9910";12;3;76;66;13133655;13137396;3741
"1006";12;3;84;67;13142426;13147143;4717
"10112";12;3;56;68;13150897;13154168;3271
"1029";12;1;34;69;13159215;13163051;3836
"10411";12;1;82;70;13172316;13177038;4722
"1057";12;1;94;71;13181965;13186215;4250
"1065";12;3;28;72;13190234;13197223;6989
"1087";12;3;92;73;13202201;13206527;4326
"10910";12;3;16;74;13210225;13214265;4040
"11115";12;1;10;75;13221144;13224426;3282
"1137";12;3;96;76;13231330;13235456;4126
"11410";12;1;58;77;13237799;13241731;3932
"1156";12;1;42;78;13244459;13248139;3680
"11611";12;1;50;79;13250877;13254055;3178
"11711";12;1;74;80;13257206;13260280;3074
"1186";12;1;62;81;13263531;13266572;3041
"11911";12;1;98;82;13269030;13272505;3475
"12011";12;1;54;83;13277324;13281517;4193
"12115";12;3;100;84;13285104;13288879;3775
"12213";12;3;52;85;13292493;13297471;4978
"1239";12;1;86;86;13306159;13309318;3159
"1245";12;1;38;87;13314309;13317753;3444
"1267";12;3;88;88;13324349;13329160;4811
"1276";12;1;30;89;13336585;13339594;3009
"1296";12;1;2;90;13348907;13352477;3570
"13110";12;3;72;91;13359811;13365587;5776
"1327";12;1;46;92;13370514;13373743;3229
"1336";12;3;4;93;13379207;13383159;3952
"13510";12;3;8;94;13391503;13395759;4256
"13711";12;3;36;95;13400767;13404275;3508
"13911";12;3;48;96;13412544;13417591;5047
"1406";12;1;78;97;13424959;13429191;4232
"14110";12;1;26;98;13432367;13436143;3776
"14311";12;1;18;99;13443773;13446707;2934
"14511";12;3;40;100;13452320;13455615;3295
"14711";12;3;20;101;13460781;13465250;4469
"1492";12;3;24;102;13470734;13475490;4756
"935";13;3;63;1;15191171;15196494;5323
"1030";13;3;79;2;15204135;15209518;5383
"1138";13;3;43;3;15250486;15255258;4772
"1240";13;3;67;4;15258845;15263399;4554
"1320";13;1;69;5;15266506;15271241;4735
"1426";13;3;11;6;15275554;15280107;4553
"165";13;1;5;7;15287624;15291923;4299
"186";13;3;31;8;15297532;15303023;5491
"206";13;1;21;9;15309921;15314381;4460
"2212";13;3;59;10;15319923;15323755;3832
"236";13;1;89;11;15328075;15331539;3464
"2412";13;1;65;12;15335018;15339188;4170
"2511";13;1;13;13;15343063;15346430;3367
"2712";13;3;75;14;15352670;15357221;4551
"286";13;3;83;15;15362309;15366412;4103
"2911";13;3;55;16;15370563;15374887;4324
"306";13;1;33;17;15380519;15385020;4501
"326";13;1;81;18;15390094;15394094;4000
"3312";13;1;93;19;15398338;15402703;4365
"3411";13;3;27;20;15409089;15413785;4696
"366";13;3;91;21;15419481;15424177;4696
"3712";13;3;15;22;15428983;15434110;5127
"3912";13;1;9;23;15440319;15444035;3716
"4112";13;3;95;24;15449976;15454084;4108
"4210";13;1;57;25;15459232;15462450;3218
"437";13;1;41;26;15465805;15468325;2520
"4410";13;1;49;27;15471774;15475292;3518
"457";13;1;73;28;15506681;15509632;2951
"4611";13;1;61;29;15513471;15516857;3386
"4712";13;1;97;30;15519427;15522815;3388
"487";13;1;53;31;15530462;15534514;4052
"4910";13;3;99;32;15539255;15543672;4417
"5012";13;3;51;33;15549317;15553905;4588
"5112";13;1;85;34;15558997;15563455;4458
"5212";13;1;37;35;15567352;15572138;4786
"546";13;3;87;36;15579570;15583488;3918
"5511";13;1;29;37;15589171;15593929;4758
"577";13;1;1;38;15601100;15605545;4445
"597";13;3;71;39;15611486;15616720;5234
"6010";13;1;45;40;15620178;15623153;2975
"617";13;3;3;41;15630300;15634777;4477
"636";13;3;7;42;15640470;15643652;3182
"6511";13;3;35;43;15651777;15655677;3900
"6712";13;3;47;44;15663224;15667951;4727
"6811";13;1;77;45;15672681;15676576;3895
"6912";13;1;25;46;15683443;15687425;3982
"717";13;1;17;47;15719985;15722766;2781
"7310";13;3;39;48;15727842;15731216;3374
"7512";13;3;19;49;15736494;15740215;3721
"7711";13;3;23;50;15745876;15749423;3547
"7911";13;2;98;51;15753822;15756256;2434
"8010";13;4;84;52;15758691;15762789;4098
"8112";13;2;82;53;15768418;15772356;3938
"8211";13;2;10;54;15775475;15778430;2955
"8411";13;4;92;55;15784828;15788988;4160
"858";13;4;36;56;15792472;15796163;3691
"875";13;2;38;57;15806593;15809304;2711
"895";13;4;8;58;15814094;15817921;3827
"9112";13;2;54;59;15822938;15826645;3707
"9212";13;4;20;60;15829309;15832662;3353
"9412";13;4;48;61;15838814;15842520;3706
"9512";13;4;56;62;15846867;15850169;3302
"968";13;4;44;63;15853228;15856911;3683
"9711";13;4;24;64;15859722;15863494;3772
"9911";13;4;40;65;15871417;15874427;3010
"10113";13;2;2;66;15879128;15881010;1882
"1039";13;4;72;67;15887748;15892534;4786
"10412";13;4;100;68;15895216;15898560;3344
"1058";13;4;16;69;15903491;15907550;4059
"10710";13;4;52;70;15913487;15916917;3430
"1088";13;2;62;71;15919908;15922067;2159
"10911";13;2;78;72;15924529;15927925;3396
"1106";13;4;96;73;15930628;15934533;3905
"11116";13;4;60;74;15937072;15940408;3336
"11212";13;4;12;75;15942687;15946641;3954
"11411";13;2;26;76;15952082;15955441;3359
"11612";13;2;86;77;15960332;15963099;2767
"11712";13;2;34;78;15966202;15968524;2322
"11912";13;4;68;79;15974165;15978006;3841
"12012";13;4;80;80;15981164;15984290;3126
"12116";13;2;94;81;15986943;15990214;3271
"12214";13;2;66;82;15993976;15997273;3297
"12310";13;2;18;83;16000666;16003572;2906
"12510";13;2;58;84;16009965;16012855;2890
"1268";13;2;6;85;16015258;16018172;2914
"1286";13;4;4;86;16024097;16027830;3733
"13010";13;4;28;87;16032726;16037013;4287
"1328";13;2;22;88;16043491;16046196;2705
"1346";13;4;76;89;16080916;16083869;2953
"13511";13;2;74;90;16086613;16089969;3356
"1366";13;4;88;91;16092809;16096211;3402
"13712";13;2;46;92;16099464;16102469;3005
"13810";13;4;64;93;16105092;16108010;2918
"13912";13;2;42;94;16110938;16113385;2447
"1407";13;2;30;95;16116894;16120135;3241
"1427";13;2;70;96;16125513;16128918;3405
"14312";13;2;50;97;16131717;16136168;4451
"1446";13;2;90;98;16138274;16141526;3252
"14512";13;4;32;99;16145785;16149325;3540
"14712";13;2;14;100;16153970;16156542;2572
"936";14;2;97;1;18082704;18090263;7559
"1040";14;4;83;2;18093000;18098288;5288
"1139";14;2;81;3;18101275;18106004;4729
"1246";14;2;9;4;18109949;18114473;4524
"1428";14;4;91;5;18121288;18130121;8833
"157";14;4;35;6;18134374;18143561;9187
"177";14;2;37;7;18155496;18161077;5581
"196";14;4;7;8;18170924;18179018;8094
"217";14;2;53;9;18187109;18192693;5584
"2213";14;4;19;10;18195987;18203159;7172
"2413";14;4;47;11;18209513;18216300;6787
"2512";14;4;55;12;18218663;18226792;8129
"267";14;4;43;13;18229245;18238249;9004
"2713";14;4;23;14;18240982;18247741;6759
"2912";14;4;39;15;18254951;18262673;7722
"317";14;2;1;16;18268967;18277006;8039
"3313";14;4;71;17;18284694;18294405;9711
"3412";14;4;99;18;18297071;18305089;8018
"357";14;4;15;19;18308188;18315179;6991
"3713";14;4;51;20;18322379;18329855;7476
"387";14;2;61;21;18332885;18339637;6752
"3913";14;2;77;22;18342085;18346570;4485
"407";14;4;95;23;18349265;18358328;9063
"4113";14;4;59;24;18361500;18368636;7136
"4211";14;4;11;25;18371975;18381227;9252
"4411";14;2;25;26;18389876;18398101;8225
"4612";14;2;85;27;18406772;18412976;6204
"4713";14;2;33;28;18415463;18419942;4479
"4911";14;4;67;29;18425551;18434167;8616
"5013";14;4;79;30;18436909;18443275;6366
"5113";14;2;93;31;18445837;18451725;5888
"5213";14;2;65;32;18453908;18461157;7249
"537";14;2;17;33;18463527;18470849;7322
"5512";14;2;57;34;18476793;18481737;4944
"566";14;2;5;35;18484376;18491601;7225
"585";14;4;3;36;18498113;18505573;7460
"6011";14;4;27;37;18512634;18520339;7705
"626";14;2;21;38;18526105;18533397;7292
"646";14;4;75;39;18540694;18551462;10768
"6512";14;2;73;40;18556910;18563623;6713
"667";14;4;87;41;18566079;18573621;7542
"6713";14;2;45;42;18576226;18579704;3478
"6812";14;4;63;43;18582057;18588584;6527
"6913";14;2;41;44;18591052;18595561;4509
"707";14;2;29;45;18598545;18605066;6521
"726";14;2;69;46;18611445;18619910;8465
"7311";14;2;49;47;18622763;18629526;6763
"747";14;2;89;48;18631888;18636212;4324
"7513";14;4;31;49;18638825;18648568;9743
"7712";14;2;13;50;18654707;18660176;5469
"7912";14;1;64;51;18666096;18672625;6529
"8011";14;1;80;52;18676247;18684516;8269
"8113";14;1;44;53;18687394;18693496;6102
"8212";14;1;68;54;18695627;18703882;8255
"836";14;3;70;55;18706325;18715023;8698
"8412";14;1;12;56;18717620;18724956;7336
"867";14;3;6;57;18730624;18737314;6690
"887";14;1;32;58;18744762;18750259;5497
"907";14;3;22;59;18758134;18766012;7878
"9213";14;1;60;60;18771982;18778493;6511
"937";14;3;90;61;18781621;18793803;12182
"9413";14;3;66;62;18796015;18806454;10439
"9513";14;3;14;63;18809695;18818160;8465
"9712";14;1;76;64;18825785;18832203;6418
"985";14;1;84;65;18834522;18842077;7555
"9912";14;1;56;66;18847069;18852260;5191
"1007";14;3;34;67;18854838;18862501;7663
"10210";14;3;82;68;18871901;18880284;8383
"10310";14;3;94;69;18882933;18891417;8484
"10413";14;1;28;70;18895262;18906025;10763
"1066";14;1;92;71;18913063;18920766;7703
"10711";14;1;16;72;18923736;18930647;6911
"10912";14;3;10;73;18937787;18948190;10403
"11117";14;1;96;74;18955349;18961423;6074
"11213";14;3;58;75;18965011;18976172;11161
"11310";14;3;42;76;18978835;18988555;9720
"11412";14;3;50;77;18991326;18999555;8229
"1157";14;3;74;78;19002589;19011060;8471
"11613";14;3;62;79;19013623;19020629;7006
"11713";14;3;98;80;19024348;19030198;5850
"1187";14;3;54;81;19066103;19077393;11290
"11913";14;1;100;82;19079890;19085625;5735
"12013";14;1;52;83;19088094;19094578;6484
"12117";14;3;86;84;19096863;19105187;8324
"12215";14;3;38;85;19108076;19114959;6883
"1247";14;1;88;86;19120502;19127149;6647
"12511";14;3;30;87;19129451;19138247;8796
"1277";14;3;2;88;19145681;19155958;10277
"1297";14;1;72;89;19165091;19174724;9633
"13011";14;3;46;90;19178780;19186815;8035
"13111";14;1;4;91;19189324;19193698;4374
"1337";14;1;8;92;19199666;19206805;7139
"13512";14;1;36;93;19213122;19219997;6875
"13713";14;1;48;94;19226963;19234321;7358
"13811";14;3;78;95;19236838;19247004;10166
"13913";14;3;26;96;19249653;19258804;9151
"14111";14;3;18;97;19265313;19272753;7440
"14313";14;1;40;98;19277999;19284203;6204
"14513";14;1;20;99;19289183;19296594;7411
"14713";14;1;24;100;19302996;19313285;10289
"938";15;1;63;1;20905292;20908085;2793
"1050";15;1;79;2;20912216;20915018;2802
"1140";15;1;43;3;20917482;20921785;4303
"1248";15;1;67;4;20924663;20929826;5163
"1329";15;3;69;5;20933938;20939759;5821
"1429";15;1;11;6;20943046;20946367;3321
"166";15;3;5;7;20951996;20957641;5645
"187";15;1;31;8;20962399;20966474;4075
"207";15;3;21;9;20971372;20976225;4853
"2214";15;1;59;10;20980740;20984241;3501
"237";15;3;89;11;20986647;20991082;4435
"2414";15;3;65;12;20993374;20999832;6458
"2513";15;3;13;13;21003423;21008056;4633
"2714";15;1;75;14;21013451;21017781;4330
"287";15;1;83;15;21020795;21024131;3336
"2913";15;1;55;16;21026361;21030897;4536
"307";15;3;33;17;21033099;21038989;5890
"327";15;3;81;18;21043975;21048672;4697
"3314";15;3;93;19;21054222;21058680;4458
"3413";15;1;27;20;21062050;21065688;3638
"367";15;1;91;21;21071612;21074679;3067
"3714";15;1;15;22;21076960;21079987;3027
"3914";15;3;9;23;21085641;21090537;4896
"4114";15;1;95;24;21095447;21099445;3998
"4212";15;3;57;25;21101655;21106695;5040
"438";15;3;41;26;21110080;21114527;4447
"4412";15;3;49;27;21116982;21122003;5021
"458";15;3;73;28;21124638;21129294;4656
"4613";15;3;61;29;21132401;21136627;4226
"4714";15;3;97;30;21139464;21146668;7204
"488";15;3;53;31;21149207;21154968;5761
"4912";15;1;99;32;21157198;21160610;3412
"5014";15;1;51;33;21163250;21166634;3384
"5114";15;3;85;34;21173107;21177992;4885
"5214";15;3;37;35;21180931;21184592;3661
"547";15;1;87;36;21189440;21192475;3035
"5513";15;3;29;37;21194932;21200483;5551
"578";15;3;1;38;21205485;21211899;6414
"598";15;1;71;39;21217127;21220441;3314
"6012";15;3;45;40;21222712;21227457;4745
"618";15;1;3;41;21229937;21233499;3562
"637";15;1;7;42;21238378;21241373;2995
"6513";15;1;35;43;21247499;21250964;3465
"6714";15;1;47;44;21256083;21260631;4548
"6813";15;3;77;45;21262933;21266264;3331
"6914";15;3;25;46;21268899;21272822;3923
"718";15;3;17;47;21278283;21284138;5855
"7312";15;1;39;48;21319988;21324212;4224
"7514";15;1;19;49;21328729;21333512;4783
"7713";15;1;23;50;21338269;21340753;2484
"7913";15;4;98;51;21345779;21349136;3357
"8012";15;2;84;52;21352514;21357352;4838
"8114";15;4;82;53;21359891;21364302;4411
"8213";15;4;10;54;21367085;21370927;3842
"8413";15;2;92;55;21374888;21378943;4055
"859";15;2;36;56;21381225;21384385;3160
"876";15;4;38;57;21389438;21393476;4038
"896";15;2;8;58;21397652;21401650;3998
"9113";15;4;54;59;21406938;21410409;3471
"9214";15;2;20;60;21414307;21416833;2526
"9414";15;2;48;61;21422451;21426383;3932
"9514";15;2;56;62;21428868;21432250;3382
"969";15;2;44;63;21434236;21437141;2905
"9713";15;2;24;64;21439568;21442999;3431
"9913";15;2;40;65;21449069;21451232;2163
"10114";15;4;2;66;21456717;21461098;4381
"10311";15;2;72;67;21467633;21471665;4032
"10414";15;2;100;68;21475815;21479181;3366
"1059";15;2;16;69;21481591;21485206;3615
"10712";15;2;52;70;21490243;21493572;3329
"1089";15;4;62;71;21496675;21499472;2797
"10913";15;4;78;72;21501753;21505180;3427
"1107";15;2;96;73;21509137;21511372;2235
"11118";15;2;60;74;21514767;21516796;2029
"11214";15;2;12;75;21520237;21522621;2384
"11413";15;4;26;76;21527359;21531005;3646
"11614";15;4;86;77;21536040;21540154;4114
"11714";15;4;34;78;21542551;21546312;3761
"11914";15;2;68;79;21553327;21557904;4577
"12014";15;2;80;80;21560621;21565111;4490
"12118";15;4;94;81;21567751;21571303;3552
"12216";15;4;66;82;21573542;21577811;4269
"12311";15;4;18;83;21582539;21586177;3638
"12512";15;4;58;84;21590880;21596202;5322
"1269";15;4;6;85;21600084;21603335;3251
"1287";15;2;4;86;21608066;21610760;2694
"13012";15;2;28;87;21616518;21620210;3692
"13210";15;4;22;88;21624750;21627451;2701
"1347";15;2;76;89;21633198;21637501;4303
"13513";15;4;74;90;21640649;21645017;4368
"1367";15;2;88;91;21647582;21651175;3593
"13714";15;4;46;92;21653211;21656658;3447
"13812";15;2;64;93;21658934;21662308;3374
"13914";15;4;42;94;21666232;21669424;3192
"1408";15;4;30;95;21672951;21677566;4615
"14210";15;4;70;96;21684920;21688724;3804
"14314";15;4;50;97;21691199;21696098;4899
"1447";15;4;90;98;21698244;21701698;3454
"14514";15;2;32;99;21703973;21706840;2867
"14714";15;4;14;100;21712358;21717139;4781
"939";16;4;97;1;23635576;23640412;4836
"1060";16;2;83;2;23642859;23646312;3453
"1150";16;4;81;3;23648681;23653483;4802
"1249";16;4;9;4;23656044;23659911;3867
"1430";16;2;91;5;23665291;23668144;2853
"158";16;2;35;6;23671532;23675211;3679
"178";16;4;37;7;23680973;23685085;4112
"197";16;2;7;8;23691103;23696502;5399
"218";16;4;53;9;23703346;23707551;4205
"2215";16;2;19;10;23713886;23718209;4323
"2415";16;2;47;11;23723387;23728001;4614
"2514";16;2;55;12;23731134;23735129;3995
"268";16;2;43;13;23738125;23742698;4573
"2715";16;2;23;14;23745459;23748585;3126
"2914";16;2;39;15;23754294;23759075;4781
"318";16;4;1;16;23764219;23768257;4038
"3315";16;2;71;17;23773413;23776482;3069
"3414";16;2;99;18;23778736;23781572;2836
"358";16;2;15;19;23784423;23787698;3275
"3715";16;2;51;20;23792579;23795348;2769
"388";16;4;61;21;23798433;23804864;6431
"3915";16;4;77;22;23807416;23810590;3174
"408";16;2;95;23;23813050;23817447;4397
"4115";16;2;59;24;23820474;23822722;2248
"4213";16;2;11;25;23825495;23828255;2760
"4413";16;4;25;26;23834068;23838788;4720
"4614";16;4;85;27;23844000;23848596;4596
"4715";16;4;33;28;23853896;23857221;3325
"4913";16;2;67;29;23861633;23864521;2888
"5015";16;2;79;30;23866947;23870546;3599
"5115";16;4;93;31;23873274;23880070;6796
"5215";16;4;65;32;23882508;23885511;3003
"538";16;4;17;33;23887909;23890820;2911
"5514";16;4;57;34;23896219;23901119;4900
"567";16;4;5;35;23903394;23907202;3808
"586";16;2;3;36;23913271;23915360;2089
"6013";16;2;27;37;23922571;23926643;4072
"627";16;4;21;38;23933371;23938183;4812
"647";16;2;75;39;23943564;23949926;6362
"6514";16;4;73;40;23953223;23957701;4478
"668";16;2;87;41;23965974;23968400;2426
"6715";16;4;45;42;23971223;23974265;3042
"6814";16;2;63;43;23976632;23979475;2843
"6915";16;4;41;44;23981900;23984416;2516
"708";16;4;29;45;23986743;23992466;5723
"727";16;4;69;46;23998186;24002557;4371
"7313";16;4;49;47;24006578;24010406;3828
"748";16;4;89;48;24015926;24019190;3264
"7515";16;2;31;49;24144462;24147362;2900
"7714";16;4;13;50;24151825;24154770;2945
"7914";16;3;64;51;24160250;24164447;4197
"8013";16;3;80;52;24166652;24171594;4942
"8115";16;3;44;53;24174524;24178094;3570
"8214";16;3;68;54;24180678;24184329;3651
"837";16;1;70;55;24186906;24190377;3471
"8414";16;3;12;56;24194936;24198310;3374
"868";16;1;6;57;24203194;24205926;2732
"888";16;3;32;58;24211342;24214875;3533
"908";16;1;22;59;24219605;24222542;2937
"9215";16;3;60;60;24227894;24232003;4109
"9310";16;1;90;61;24235767;24238642;2875
"9415";16;1;66;62;24241354;24245092;3738
"9515";16;1;14;63;24247825;24250149;2324
"9714";16;3;76;64;24256643;24260614;3971
"986";16;3;84;65;24263765;24267932;4167
"9914";16;3;56;66;24270302;24273991;3689
"1008";16;1;34;67;24277552;24282407;4855
"10211";16;1;82;68;24287241;24290767;3526
"10312";16;1;94;69;24297378;24300448;3070
"10415";16;3;28;70;24308184;24313647;5463
"1067";16;3;92;71;24321037;24325372;4335
"10810";16;3;16;73;24363396;24367954;4558
"1108";16;1;10;74;24373285;24376520;3235
"11215";16;3;96;75;24381453;24385086;3633
"11311";16;1;58;76;24387261;24391253;3992
"11414";16;1;42;77;24393986;24396828;2842
"1158";16;1;50;78;24399597;24402655;3058
"11615";16;1;74;79;24405250;24407269;2019
"11715";16;1;62;80;24409637;24411486;1849
"1188";16;1;98;81;24413816;24415835;2019
"11915";16;1;54;82;24418007;24420360;2353
"12015";16;3;100;83;24422622;24425843;3221
"12119";16;3;52;84;24428372;24431660;3288
"12217";16;1;86;85;24434844;24436817;1973
"12312";16;1;38;86;24439527;24441885;2358
"12513";16;3;88;87;24447516;24450776;3260
"12610";16;1;30;88;24453178;24455609;2431
"1288";16;1;2;89;24461617;24465725;4108
"13013";16;3;72;90;24471086;24474492;3406
"13112";16;1;46;91;24476893;24479183;2290
"13211";16;3;4;92;24481827;24484900;3073
"1348";16;3;8;93;24490460;24493917;3457
"1368";16;3;36;94;24498742;24503133;4391
"13813";16;3;48;95;24507932;24511724;3792
"13915";16;1;78;96;24514090;24518165;4075
"1409";16;1;26;97;24520395;24522640;2245
"14211";16;1;18;98;24527699;24529515;1816
"1448";16;3;40;99;24534253;24537591;3338
"1461";16;3;20;100;24542406;24546513;4107
"1481";16;3;24;101;24551285;24554322;3037
"940";17;3;63;1;913168;916685;3517
"1068";17;3;79;2;919029;922531;3502
"1159";17;3;43;3;924982;928864;3882
"1250";17;3;67;4;931222;935297;4075
"1330";17;1;69;5;937535;941086;3551
"1440";17;3;11;6;943910;947580;3670
"167";17;1;5;7;954340;957911;3571
"188";17;3;31;8;964073;969200;5127
"208";17;1;21;9;974107;977321;3214
"2216";17;3;59;10;982516;986112;3596
"238";17;1;89;11;989279;992130;2851
"2416";17;1;65;12;995576;999587;4011
"2515";17;1;13;13;1002556;1005603;3047
"2716";17;3;75;14;1011387;1015795;4408
"288";17;3;83;15;1018051;1021786;3735
"2915";17;3;55;16;1024080;1027694;3614
"308";17;1;33;17;1030614;1033364;2750
"328";17;1;81;18;1038070;1040669;2599
"3316";17;1;93;19;1042887;1046054;3167
"3415";17;3;27;20;1048620;1052318;3698
"368";17;3;91;21;1059830;1063887;4057
"3716";17;3;15;22;1068223;1072101;3878
"3916";17;1;9;23;1077341;1080376;3035
"4116";17;3;95;24;1085609;1089883;4274
"4214";17;1;57;25;1092101;1094850;2749
"439";17;1;41;26;1097149;1100602;3453
"4414";17;1;49;27;1103275;1107008;3733
"459";17;1;73;28;1109272;1112508;3236
"4615";17;1;61;29;1114686;1117315;2629
"4716";17;1;97;30;1119521;1124349;4828
"489";17;1;53;31;1126952;1130140;3188
"4914";17;3;99;32;1133344;1137117;3773
"5016";17;3;51;33;1139413;1143373;3960
"5116";17;1;85;34;1145626;1149020;3394
"5216";17;1;37;35;1151197;1154014;2817
"548";17;3;87;36;1159468;1163489;4021
"5515";17;1;29;37;1165710;1169397;3687
"579";17;1;1;38;1174439;1178147;3708
"599";17;3;71;39;1183480;1187530;4050
"6014";17;1;45;40;1189744;1192248;2504
"619";17;3;3;41;1194423;1197704;3281
"638";17;3;7;42;1202863;1206321;3458
"6515";17;3;35;43;1211632;1215561;3929
"6716";17;3;47;44;1220493;1223970;3477
"6815";17;1;77;45;1226134;1229037;2903
"6916";17;1;25;46;1232652;1235387;2735
"719";17;1;17;47;1240267;1243886;3619
"7314";17;3;39;48;1279654;1283767;4113
"7516";17;3;19;49;1288987;1307935;18948
"7715";17;3;23;50;1362167;1365701;3534
"7915";17;2;98;51;1373214;1375582;2368
"8014";17;4;84;52;1377832;1382391;4559
"8116";17;2;82;53;1384675;1387466;2791
"8215";17;2;10;54;1389709;1392449;2740
"8415";17;4;92;55;1397895;1404726;6831
"8510";17;4;36;56;1406994;1410623;3629
"877";17;2;38;57;1417065;1420040;2975
"897";17;4;8;58;1425133;1428801;3668
"9114";17;2;54;59;1434821;1436972;2151
"9216";17;4;20;60;1439227;1442247;3020
"9416";17;4;48;61;1446785;1450647;3862
"9516";17;4;56;62;1452909;1456605;3696
"9610";17;4;44;63;1458974;1461731;2757
"9715";17;4;24;64;1464010;1467363;3353
"9915";17;4;40;65;1472697;1475580;2883
"10115";17;2;2;66;1481617;1484571;2954
"10313";17;4;72;67;1490013;1494745;4732
"10416";17;4;100;68;1497665;1500854;3189
"10510";17;4;16;69;1547071;1550633;3562
"10713";17;4;52;70;1555798;1559185;3387
"10811";17;2;62;71;1563190;1565668;2478
"10914";17;2;78;72;1567877;1571101;3224
"1109";17;4;96;73;1573276;1576167;2891
"11119";17;4;60;74;1578618;1581243;2625
"11216";17;4;12;75;1583492;1586542;3050
"11415";17;2;26;76;1591094;1593267;2173
"11616";17;2;86;77;1598185;1600260;2075
"11716";17;2;34;78;1602442;1605373;2931
"11916";17;4;68;79;1610237;1613891;3654
"12016";17;4;80;80;1616170;1619478;3308
"12120";17;2;94;81;1621649;1623958;2309
"12218";17;2;66;82;1626630;1629957;3327
"12313";17;2;18;83;1632754;1635079;2325
"12514";17;2;58;84;1639700;1642790;3090
"12611";17;2;6;85;1644986;1647287;2301
"1289";17;4;4;86;1652092;1654973;2881
"13014";17;4;28;87;1659852;1663306;3454
"13212";17;2;22;88;1668083;1670372;2289
"1349";17;4;76;89;1675376;1677985;2609
"13514";17;2;74;90;1680248;1682764;2516
"1369";17;4;88;91;1685031;1687978;2947
"13715";17;2;46;92;1691892;1694263;2371
"13814";17;4;64;93;1696513;1699796;3283
"13916";17;2;42;94;1702591;1704788;2197
"14010";17;2;30;95;1707344;1709988;2644
"14212";17;2;70;96;1716354;1718779;2425
"14315";17;2;50;97;1721371;1724037;2666
"1449";17;2;90;98;1726257;1728354;2097
"14515";17;4;32;99;1730536;1733220;2684
"14715";17;2;14;100;1738265;1740702;2437
"950";18;2;97;1;619742;622945;3203
"1069";18;4;83;2;625636;628119;2483
"1160";18;2;81;3;631348;634411;3063
"1260";18;2;9;4;637662;640444;2782
"1450";18;4;91;5;645377;648977;3600
"159";18;4;35;6;651526;655777;4251
"179";18;2;37;7;661275;663651;2376
"198";18;4;7;8;669981;672851;2870
"219";18;2;53;9;679792;682417;2625
"2217";18;4;19;10;685589;688817;3228
"2417";18;4;47;11;693760;697525;3765
"2516";18;4;55;12;700688;705017;4329
"269";18;4;43;13;707647;712408;4761
"2717";18;4;23;14;714992;718533;3541
"2916";18;4;39;15;724469;727249;2780
"319";18;2;1;16;732670;736166;3496
"3317";18;4;71;17;741996;746873;4877
"3416";18;4;99;18;749795;752523;2728
"359";18;4;15;19;756389;759840;3451
"3717";18;4;51;20;764572;768964;4392
"389";18;2;61;21;771569;774406;2837
"3917";18;2;77;22;781114;785197;4083
"409";18;4;95;23;789817;793705;3888
"4117";18;4;59;24;797069;799972;2903
"4215";18;4;11;25;802485;805696;3211
"4415";18;2;25;26;810866;813454;2588
"4616";18;2;85;27;819535;822629;3094
"4717";18;2;33;28;825167;827246;2079
"4915";18;4;67;29;831753;834870;3117
"5017";18;4;79;30;838487;842387;3900
"5117";18;2;93;31;844882;848020;3138
"5217";18;2;65;32;850510;853569;3059
"539";18;2;17;33;855889;858328;2439
"5516";18;2;57;34;864119;866736;2617
"568";18;2;5;35;869963;873136;3173
"587";18;4;3;36;878307;880635;2328
"6015";18;4;27;37;886425;890585;4160
"628";18;2;21;38;895196;897285;2089
"648";18;4;75;39;902765;906668;3903
"6516";18;2;73;40;910193;912626;2433
"669";18;4;87;41;914889;917359;2470
"6717";18;2;45;42;919832;921392;1560
"6816";18;4;63;43;924560;927059;2499
"6917";18;2;41;44;929640;931167;1527
"709";18;2;29;45;934272;937533;3261
"728";18;2;69;46;942660;944758;2098
"7315";18;2;49;47;947198;949941;2743
"749";18;2;89;48;952478;954133;1655
"7517";18;4;31;49;956950;960774;3824
"7716";18;2;13;50;965846;967999;2153
"7916";18;1;64;51;972919;976415;3496
"8015";18;1;80;52;979208;984257;5049
"8117";18;1;44;53;987533;989998;2465
"8216";18;1;68;54;992881;995531;2650
"838";18;3;70;55;999596;1003414;3818
"8416";18;1;12;56;1006069;1008114;2045
"869";18;3;6;57;1013755;1016189;2434
"889";18;1;32;58;1021925;1024430;2505
"909";18;3;22;59;1030285;1033805;3520
"9217";18;1;60;60;1039809;1041563;1754
"9311";18;3;90;61;1043876;1046896;3020
"9417";18;3;66;62;1049386;1052537;3151
"9517";18;3;14;63;1055817;1058646;2829
"9716";18;1;76;64;1063384;1065729;2345
"987";18;1;84;65;1069024;1071512;2488
"9916";18;1;56;66;1075117;1077112;1995
"1009";18;3;34;67;1079530;1082544;3014
"10212";18;3;82;68;1088989;1093461;4472
"10314";18;3;94;69;1095985;1099269;3284
"10417";18;1;28;70;1102461;1104727;2266
"10610";18;1;92;71;1110027;1112652;2625
"10714";18;1;16;72;1114900;1117285;2385
"10915";18;3;10;73;1122304;1125018;2714
"11120";18;1;96;74;1130778;1133584;2806
"11217";18;3;58;75;1136578;1139168;2590
"11312";18;3;42;76;1142428;1146101;3673
"11416";18;3;50;77;1148595;1152492;3897
"11510";18;3;74;78;1154760;1157825;3065
"11617";18;3;62;79;1160137;1162992;2855
"11717";18;3;98;80;1165289;1167891;2602
"1189";18;3;54;81;1172762;1177150;4388
"11917";18;1;100;82;1179615;1181899;2284
"12017";18;1;52;83;1184663;1187216;2553
"12121";18;3;86;84;1190441;1193074;2633
"12219";18;3;38;85;1196971;1199940;2969
"12410";18;1;88;86;1204809;1208282;3473
"12515";18;3;30;87;1210663;1213490;2827
"1278";18;3;2;88;1218550;1221549;2999
"1298";18;1;72;89;1226754;1227656;902
"13015";18;3;46;90;1230367;1235139;4772
"13113";18;1;4;91;1238239;1240631;2392
"1338";18;1;8;92;1246091;1248372;2281
"13515";18;1;36;93;1253100;1255722;2622
"13716";18;1;48;94;1260278;1263171;2893
"13815";18;3;78;95;1265567;1268954;3387
"13917";18;3;26;96;1271718;1274321;2603
"14112";18;3;18;97;1279441;1281721;2280
"14316";18;1;40;98;1286775;1288462;1687
"14516";18;1;20;99;1293405;1295820;2415
"14716";18;1;24;100;1300780;1303370;2590
"960";19;1;63;1;3398459;3406798;8339
"1070";19;1;79;2;3409184;3421548;12364
"1170";19;1;43;3;3426745;3434380;7635
"1270";19;1;67;4;3437755;3446813;9058
"1339";19;3;69;5;3450263;3461096;10833
"1460";19;1;11;6;3465039;3474537;9498
"168";19;3;5;7;3481291;3491128;9837
"189";19;1;31;8;3499097;3510736;11639
"209";19;3;21;9;3517080;3526185;9105
"2218";19;1;59;10;3531910;3540818;8908
"239";19;3;89;11;3546685;3554067;7382
"2418";19;3;65;12;3557630;3567359;9729
"2517";19;3;13;13;3571298;3583467;12169
"2718";19;1;75;14;3590049;3606424;16375
"289";19;1;83;15;3616431;3621898;5467
"2917";19;1;55;16;3625255;3630873;5618
"309";19;3;33;17;3633222;3638390;5168
"329";19;3;81;18;3643867;3652189;8322
"3318";19;3;93;19;3654622;3662472;7850
"3417";19;1;27;20;3664751;3675080;10329
"369";19;1;91;21;3681518;3688404;6886
"3718";19;1;15;22;3692083;3700254;8171
"3918";19;3;9;23;3708051;3717161;9110
"4118";19;1;95;24;3724247;3730586;6339
"4216";19;3;57;25;3733123;3738119;4996
"4310";19;3;41;26;3742159;3750685;8526
"4416";19;3;49;27;3753679;3762535;8856
"4510";19;3;73;28;3765135;3774810;9675
"4617";19;3;61;29;3777642;3786226;8584
"4718";19;3;97;30;3789367;3797826;8459
"4810";19;3;53;31;3800443;3808825;8382
"4916";19;1;99;32;3811302;3817392;6090
"5018";19;1;51;33;3821107;3826424;5317
"5118";19;3;85;34;3829695;3838891;9196
"5218";19;3;37;35;3842792;3852382;9590
"549";19;1;87;36;3857980;3862481;4501
"5517";19;3;29;37;3864667;3873406;8739
"5710";19;3;1;38;3879476;3886256;6780
"5910";19;1;71;39;3893433;3899722;6289
"6016";19;3;45;40;3901983;3910404;8421
"6110";19;1;3;41;3914259;3918446;4187
"639";19;1;7;42;3926734;3932504;5770
"6517";19;1;35;43;3949458;3955545;6087
"6718";19;1;47;44;3963061;3967511;4450
"6817";19;3;77;45;3969868;3975111;5243
"6918";19;3;25;46;3978472;3986502;8030
"7110";19;3;17;47;3992681;3999610;6929
"7316";19;1;39;48;4005307;4010034;4727
"7518";19;1;19;49;4015734;4023100;7366
"7717";19;1;23;50;4033828;4038958;5130
"7917";19;4;98;51;4045870;4054233;8363
"8016";19;2;84;52;4059677;4067165;7488
"8118";19;4;82;53;4071516;4078665;7149
"8217";19;4;10;54;4081499;4093498;11999
"8417";19;2;92;55;4100286;4106631;6345
"8511";19;2;36;56;4108867;4115180;6313
"878";19;4;38;57;4122306;4128413;6107
"898";19;2;8;58;4136267;4141488;5221
"9115";19;4;54;59;4147769;4153596;5827
"9218";19;2;20;60;4155814;4160654;4840
"9418";19;2;48;61;4167319;4175787;8468
"9518";19;2;56;62;4177856;4182970;5114
"9611";19;2;44;63;4190455;4198494;8039
"9717";19;2;24;64;4200982;4207160;6178
"9917";19;2;40;65;4213097;4216885;3788
"10116";19;4;2;66;4224802;4230176;5374
"10315";19;2;72;67;4235941;4242809;6868
"10418";19;2;100;68;4245848;4251059;5211
"10511";19;2;16;69;4253393;4258425;5032
"10715";19;2;52;70;4264660;4270092;5432
"10812";19;4;62;71;4273286;4280708;7422
"10916";19;4;78;72;4284178;4290949;6771
"11010";19;2;96;73;4294151;4300207;6056
"11121";19;2;60;74;4303733;4309207;5474
"11218";19;2;12;75;4311409;4315856;4447
"11417";19;4;26;76;4320619;4327006;6387
"11618";19;4;86;77;4332777;4338706;5929
"11718";19;4;34;78;4341740;4348955;7215
"11918";19;2;68;79;4356032;4361421;5389
"12018";19;2;80;80;4363703;4368538;4835
"12122";19;4;94;81;4371610;4378729;7119
"12220";19;4;66;82;4380957;4388587;7630
"12314";19;4;18;83;4392477;4398578;6101
"12516";19;4;58;84;4405621;4412578;6957
"12612";19;4;6;85;4414964;4422102;7138
"12810";19;2;4;86;4428406;4438294;9888
"13016";19;2;28;87;4444476;4454285;9809
"13213";19;4;22;88;4465079;4471526;6447
"13410";19;2;76;89;4476399;4483150;6751
"13516";19;4;74;90;4485444;4493542;8098
"13610";19;2;88;91;4497650;4506475;8825
"13717";19;4;46;92;4509808;4515499;5691
"13816";19;2;64;93;4518634;4525915;7281
"13918";19;4;42;94;4529413;4540557;11144
"14011";19;4;30;95;4542816;4548489;5673
"14213";19;4;70;96;4563797;4572739;8942
"14317";19;4;50;97;4574960;4582113;7153
"14410";19;4;90;98;4584199;4591605;7406
"14517";19;2;32;99;4593813;4599146;5333
"14717";19;4;14;100;4608366;4616454;8088
"970";20;4;97;1;5021628;5026706;5078
"1080";20;2;83;2;5029366;5032639;3273
"1180";20;4;81;3;5039485;5043296;3811
"1279";20;4;9;4;5046255;5050289;4034
"1462";20;2;91;5;5056309;5059297;2988
"1510";20;2;35;6;5061893;5065796;3903
"1710";20;4;37;7;5072178;5076396;4218
"199";20;2;7;8;5084896;5089271;4375
"2110";20;4;53;9;5101440;5105470;4030
"2219";20;2;19;10;5110487;5113700;3213
"2419";20;2;47;11;5119738;5122757;3019
"2518";20;2;55;12;5125314;5128394;3080
"2610";20;2;43;13;5132767;5136619;3852
"2719";20;2;23;14;5139236;5142886;3650
"2918";20;2;39;15;5148065;5153018;4953
"3110";20;4;1;16;5158996;5163484;4488
"3319";20;2;71;17;5170250;5174709;4459
"3418";20;2;99;18;5177558;5180701;3143
"3510";20;2;15;19;5183741;5186992;3251
"3719";20;2;51;20;5193063;5196554;3491
"3810";20;4;61;21;5230844;5234848;4004
"3919";20;4;77;22;5238185;5242365;4180
"4010";20;2;95;23;5244848;5248331;3483
"4119";20;2;59;24;5250997;5254915;3918
"4217";20;2;11;25;5257431;5260782;3351
"4417";20;4;25;26;5267195;5273264;6069
"4618";20;4;85;27;5279524;5283825;4301
"4719";20;4;33;28;5287581;5290888;3307
"4917";20;2;67;29;5296138;5299963;3825
"5019";20;2;79;30;5303066;5305937;2871
"5119";20;4;93;31;5308353;5313904;5551
"5219";20;4;65;32;5316935;5321778;4843
"5310";20;4;17;33;5324432;5328670;4238
"5518";20;4;57;34;5334217;5338144;3927
"569";20;4;5;35;5340884;5344820;3936
"588";20;2;3;36;5351022;5354980;3958
"6017";20;2;27;37;5363749;5367435;3686
"629";20;4;21;38;5372684;5375927;3243
"649";20;2;75;39;5383237;5388415;5178
"6518";20;4;73;40;5391288;5396543;5255
"6610";20;2;87;41;5398840;5402312;3472
"6719";20;4;45;42;5405355;5409051;3696
"6818";20;2;63;43;5411878;5415767;3889
"6919";20;4;41;44;5418321;5422483;4162
"7010";20;4;29;45;5425474;5431706;6232
"729";20;4;69;46;5439368;5446426;7058
"7317";20;4;49;47;5449958;5454965;5007
"7410";20;4;89;48;5457452;5461308;3856
"7519";20;2;31;49;5464048;5468232;4184
"7718";20;4;13;50;5475841;5480139;4298
"7918";20;3;64;51;5486015;5492172;6157
"8017";20;3;80;52;5495314;5501422;6108
"8119";20;3;44;53;5503993;5509831;5838
"8218";20;3;68;54;5512411;5518821;6410
"839";20;1;70;55;5522134;5525921;3787
"8418";20;3;12;56;5528680;5534387;5707
"8610";20;1;6;57;5540231;5543905;3674
"8810";20;3;32;58;5549296;5555257;5961
"9010";20;1;22;59;5562233;5565762;3529
"9219";20;3;60;60;5571240;5577903;6663
"9312";20;1;90;61;5580528;5585219;4691
"9419";20;1;66;62;5588364;5593556;5192
"9519";20;1;14;63;5596607;5600885;4278
"9718";20;3;76;64;5606892;5612460;5568
"988";20;3;84;65;5614934;5621558;6624
"9918";20;3;56;66;5624017;5629676;5659
"10010";20;1;34;67;5632682;5637867;5185
"10213";20;1;82;68;5643751;5647533;3782
"10316";20;1;94;69;5650749;5655374;4625
"10419";20;3;28;70;5657918;5663650;5732
"10611";20;3;92;71;5669962;5674916;4954
"10716";20;3;16;72;5678160;5683930;5770
"10917";20;1;10;73;5690202;5694323;4121
"11122";20;3;96;74;5700569;5704396;3827
"11219";20;1;58;75;5706799;5710056;3257
"11313";20;1;42;76;5713110;5717061;3951
"11418";20;1;50;77;5719790;5724472;4682
"11511";20;1;74;78;5730196;5734070;3874
"11619";20;1;62;79;5736470;5739647;3177
"11719";20;1;98;80;5742243;5746396;4153
"11810";20;1;54;81;5748788;5752759;3971
"11919";20;3;100;82;5755692;5763029;7337
"12019";20;3;52;83;5766978;5772881;5903
"12123";20;1;86;84;5777215;5781369;4154
"12221";20;1;38;85;5783699;5787511;3812
"12411";20;3;88;86;5792965;5797728;4763
"12517";20;1;30;87;5801349;5804451;3102
"12710";20;1;2;88;5810827;5813761;2934
"1299";20;3;72;89;5820127;5827127;7000
"13017";20;1;46;90;5830168;5834476;4308
"13114";20;3;4;91;5837956;5842343;4387
"13310";20;3;8;92;5848549;5853609;5060
"13517";20;3;36;93;5859771;5864842;5071
"13718";20;3;48;94;5870566;5876258;5692
"13817";20;1;78;95;5878958;5882800;3842
"13919";20;1;26;96;5886244;5890025;3781
"14113";20;1;18;97;5895994;5899716;3722
"14318";20;3;40;98;5904999;5909241;4242
"14518";20;3;20;99;5914795;5919490;4695
"14718";20;3;24;100;5925031;5931281;6250
"980";21;3;63;1;6953379;6956571;3192
"1090";21;3;79;2;6960485;6964446;3961
"1190";21;3;43;3;6968497;6971603;3106
"1280";21;3;67;4;6974801;6978170;3369
"1340";21;1;69;5;6981947;6985153;3206
"1463";21;3;11;6;6987609;6991261;3652
"169";21;1;5;7;6996712;6999420;2708
"1810";21;3;31;8;7004810;7008410;3600
"2010";21;1;21;9;7016040;7019821;3781
"2220";21;3;59;10;7025902;7029359;3457
"2310";21;1;89;11;7032386;7034751;2365
"2420";21;1;65;12;7037057;7038983;1926
"2519";21;1;13;13;7041466;7043126;1660
"2720";21;3;75;14;7050122;7052901;2779
"2810";21;3;83;15;7056289;7058750;2461
"2919";21;3;55;16;7061611;7064200;2589
"3010";21;1;33;17;7066821;7069113;2292
"3210";21;1;81;18;7074148;7077000;2852
"3320";21;1;93;19;7079850;7082024;2174
"3419";21;3;27;20;7084855;7087483;2628
"3610";21;3;91;21;7093712;7096665;2953
"3720";21;3;15;22;7100633;7103765;3132
"3920";21;1;9;23;7110144;7111940;1796
"4120";21;3;95;24;7117238;7119349;2111
"4218";21;1;57;25;7121846;7123864;2018
"4311";21;1;41;26;7126037;7128048;2011
"4418";21;1;49;27;7130288;7131845;1557
"4511";21;1;73;28;7134880;7136764;1884
"4619";21;1;61;29;7139813;7141558;1745
"4720";21;1;97;30;7144139;7146355;2216
"4811";21;1;53;31;7148581;7151105;2524
"4918";21;3;99;32;7154097;7156588;2491
"5020";21;3;51;33;7160422;7163316;2894
"5120";21;1;85;34;7165501;7167127;1626
"5220";21;1;37;35;7169706;7171813;2107
"5410";21;3;87;36;7177482;7179744;2262
"5519";21;1;29;37;7182380;7183904;1524
"5711";21;1;1;38;7189095;7191554;2459
"5911";21;3;71;39;7197614;7199778;2164
"6018";21;1;45;40;7202545;7204237;1692
"6111";21;3;3;41;7207625;7210170;2545
"6310";21;3;7;42;7215004;7218058;3054
"6519";21;3;35;43;7224077;7226327;2250
"6720";21;3;47;44;7231254;7233452;2198
"6819";21;1;77;45;7236068;7237702;1634
"6920";21;1;25;46;7239896;7241635;1739
"7111";21;1;17;47;7249101;7251460;2359
"7318";21;3;39;48;7256084;7258601;2517
"7520";21;3;19;49;7264528;7267468;2940
"7719";21;3;23;50;7273277;7275867;2590
"7919";21;2;98;51;7280359;7282234;1875
"8018";21;4;84;52;7286072;7288216;2144
"8120";21;2;82;53;7291486;7292767;1281
"8219";21;2;10;54;7297359;7298641;1282
"8419";21;4;92;55;7303923;7306025;2102
"8512";21;4;36;56;7308967;7310810;1843
"879";21;2;38;57;7316615;7318146;1531
"899";21;4;8;58;7323676;7325426;1750
"9116";21;2;54;59;7330087;7331608;1521
"9220";21;4;20;60;7333805;7335419;1614
"9420";21;4;48;61;7341035;7343165;2130
"9520";21;4;56;62;7345335;7347532;2197
"9612";21;4;44;63;7350120;7352440;2320
"9719";21;4;24;64;7355159;7357716;2557
"9919";21;4;40;65;7363608;7365198;1590
"10117";21;2;2;66;7370393;7372531;2138
"10317";21;4;72;67;7378200;7380539;2339
"10420";21;4;100;68;7383007;7385047;2040
"10512";21;4;16;69;7387416;7389605;2189
"10717";21;4;52;70;7395677;7397563;1886
"10813";21;2;62;71;7399722;7401063;1341
"10918";21;2;78;72;7404666;7406305;1639
"11011";21;4;96;73;7409834;7411471;1637
"11123";21;4;60;74;7414118;7415629;1511
"11220";21;4;12;75;7418552;7420062;1510
"11419";21;2;26;76;7424742;7426912;2170
"11620";21;2;86;77;7434147;7435512;1365
"11720";21;2;34;78;7437943;7439498;1555
"11920";21;4;68;79;7445566;7447578;2012
"12020";21;4;80;80;7450802;7452753;1951
"12124";21;2;94;81;7456356;7457861;1505
"12222";21;2;66;82;7460500;7462002;1502
"12315";21;2;18;83;7464636;7466202;1566
"12518";21;2;58;84;7471396;7473235;1839
"12613";21;2;6;85;7476346;7478060;1714
"12811";21;4;4;86;7483484;7485140;1656
"13018";21;4;28;87;7490181;7492460;2279
"13214";21;2;22;88;7499578;7501068;1490
"13411";21;4;76;89;7507426;7509047;1621
"13518";21;2;74;90;7511949;7513534;1585
"13611";21;4;88;91;7517389;7518934;1545
"13719";21;2;46;92;7521178;7522701;1523
"13818";21;4;64;93;7525378;7527009;1631
"13920";21;2;42;94;7530216;7531583;1367
"14012";21;2;30;95;7534111;7535783;1672
"14214";21;2;70;96;7541160;7542641;1481
"14319";21;2;50;97;7544927;7546483;1556
"14411";21;2;90;98;7549157;7550382;1225
"14519";21;4;32;99;7553166;7554745;1579
"14719";21;2;14;100;7561436;7563832;2396
"989";22;2;97;1;8362616;8366880;4264
"10100";22;4;83;2;8374027;8378330;4303
"11100";22;2;81;3;8384294;8388763;4469
"1290";22;2;9;4;8393483;8396956;3473
"1464";22;4;91;5;8410085;8414645;4560
"1511";22;4;35;6;8417396;8422294;4898
"1711";22;2;37;7;8428532;8432311;3779
"1910";22;4;7;8;8439494;8445302;5808
"2111";22;2;53;9;8451604;8455010;3406
"2221";22;4;19;10;8457526;8462302;4776
"2520";22;4;47;12;8510818;8515772;4954
"2611";22;4;55;13;8518430;8522841;4411
"2721";22;4;43;14;8525308;8529756;4448
"2811";22;4;23;15;8532738;8537966;5228
"3011";22;4;39;16;8543893;8550310;6417
"3211";22;2;1;17;8556205;8560463;4258
"3420";22;4;71;18;8567786;8573048;5262
"3511";22;4;99;19;8575840;8580768;4928
"3611";22;4;15;20;8584117;8589456;5339
"3811";22;4;51;21;8596949;8601697;4748
"3921";22;2;61;22;8604316;8608986;4670
"4011";22;2;77;23;8612177;8616221;4044
"4121";22;4;95;24;8619514;8623907;4393
"4219";22;4;59;25;8626379;8630854;4475
"4312";22;4;11;26;8633576;8638237;4661
"4512";22;2;25;27;8644447;8648962;4515
"4721";22;2;85;28;8655961;8661020;5059
"4812";22;2;33;29;8663298;8667728;4430
"5021";22;4;67;30;8673460;8678302;4842
"5121";22;4;79;31;8681436;8685855;4419
"5221";22;2;93;32;8688411;8692935;4524
"5311";22;2;65;33;8696832;8700840;4008
"5411";22;2;17;34;8703768;8708417;4649
"5610";22;2;57;35;8716707;8720509;3802
"5712";22;2;5;36;8723195;8727274;4079
"5912";22;4;3;37;8733389;8738707;5318
"6112";22;4;27;38;8744716;8749817;5101
"6311";22;2;21;39;8755414;8759341;3927
"6520";22;4;75;40;8766461;8772477;6016
"6611";22;2;73;41;8775168;8780029;4861
"6721";22;4;87;42;8782682;8787390;4708
"6820";22;2;45;43;8790238;8793310;3072
"6921";22;4;63;44;8795805;8800565;4760
"7011";22;2;41;45;8803220;8806115;2895
"7112";22;2;29;46;8808585;8813056;4471
"7319";22;2;69;47;8821638;8825939;4301
"7411";22;2;49;48;8829857;8833201;3344
"7521";22;2;89;49;8919882;8923647;3765
"761";22;4;31;50;8926617;8931768;5151
"781";22;2;13;51;8938098;8941651;3553
"8019";22;1;64;52;8947170;8951901;4731
"8121";22;1;80;53;8954892;8960073;5181
"8220";22;1;44;54;8964317;8968342;4025
"8310";22;1;68;55;9048316;9052047;3731
"8420";22;3;70;56;9054842;9060089;5247
"8513";22;1;12;57;9062696;9066656;3960
"8710";22;3;6;58;9073946;9079005;5059
"8910";22;1;32;59;9084611;9088796;4185
"9117";22;3;22;60;9096134;9100746;4612
"9313";22;1;60;61;9106399;9110462;4063
"9421";22;3;90;62;9113046;9118862;5816
"9521";22;3;66;63;9124432;9130045;5613
"9613";22;3;14;64;9132646;9138589;5943
"9810";22;1;76;65;9148714;9152219;3505
"9920";22;1;84;66;9160943;9166135;5192
"10118";22;1;56;68;9205408;9209225;3817
"10214";22;3;34;69;9211938;9217091;5153
"10421";22;3;82;70;9222863;9227816;4953
"10513";22;3;94;71;9230415;9235874;5459
"10612";22;1;28;72;9238467;9243140;4673
"10814";22;1;92;73;9250044;9254490;4446
"10919";22;1;16;74;9257998;9263081;5083
"11124";22;3;10;75;9268776;9275198;6422
"11314";22;1;96;76;9281578;9284956;3378
"11420";22;3;58;77;9287478;9292872;5394
"11512";22;3;42;78;9295264;9300413;5149
"11621";22;3;50;79;9303005;9308971;5966
"11721";22;3;74;80;9312022;9317838;5816
"11811";22;3;62;81;9322615;9327879;5264
"11921";22;3;98;82;9330387;9335237;4850
"12021";22;3;54;83;9337687;9342987;5300
"12125";22;1;100;84;9345646;9349628;3982
"12223";22;1;52;85;9352181;9357436;5255
"12316";22;3;86;86;9361089;9366653;5564
"12412";22;3;38;87;9369383;9374286;4903
"12614";22;1;88;88;9379920;9384143;4223
"12711";22;3;30;89;9386739;9391910;5171
"12910";22;3;2;90;9397475;9403151;5676
"13115";22;1;72;91;9408960;9414793;5833
"13215";22;3;46;92;9419942;9426042;6100
"13311";22;1;4;93;9429300;9433377;4077
"13519";22;1;8;94;9440268;9446066;5798
"13720";22;1;36;95;9452030;9456999;4969
"13921";22;1;48;96;9462912;9466827;3915
"14013";22;3;78;97;9470246;9476090;5844
"14114";22;3;26;98;9478989;9484693;5704
"14320";22;3;18;99;9491528;9497673;6145
"14520";22;1;40;100;9503011;9506364;3353
"14720";22;1;20;101;9513482;9517097;3615
"1493";22;1;24;102;9522457;9526847;4390
"990";23;1;63;1;17087353;17091690;4337
"10101";23;1;79;2;17096641;17100248;3607
"11101";23;1;43;3;17103658;17107257;3599
"12100";23;1;67;4;17111403;17114973;3570
"1350";23;3;69;5;17119264;17125980;6716
"1465";23;1;11;6;17128579;17131656;3077
"1610";23;3;5;7;17138604;17142505;3901
"1811";23;1;31;8;17149820;17153971;4151
"2011";23;3;21;9;17160039;17164558;4519
"2222";23;1;59;10;17171511;17175446;3935
"2311";23;3;89;11;17179145;17183912;4767
"2421";23;3;65;12;17187838;17192758;4920
"2521";23;3;13;13;17196193;17200561;4368
"2722";23;1;75;14;17209305;17213211;3906
"2812";23;1;83;15;17215589;17217536;1947
"2920";23;1;55;16;17220484;17224061;3577
"3012";23;3;33;17;17227391;17231522;4131
"3212";23;3;81;18;17241489;17247134;5645
"3321";23;3;93;19;17249686;17254035;4349
"3421";23;1;27;20;17257050;17261509;4459
"3612";23;1;91;21;17268622;17271042;2420
"3721";23;1;15;22;17274926;17277621;2695
"3922";23;3;9;23;17285152;17287625;2473
"4122";23;1;95;24;17296112;17298702;2590
"4220";23;3;57;25;17302956;17306974;4018
"4313";23;3;41;26;17311278;17314895;3617
"4419";23;3;49;27;17318198;17322040;3842
"4513";23;3;73;28;17324653;17329465;4812
"4620";23;3;61;29;17331990;17335773;3783
"4722";23;3;97;30;17338315;17341665;3350
"4813";23;3;53;31;17344546;17345789;1243
"4919";23;1;99;32;17350304;17354714;4410
"5022";23;1;51;33;17361212;17364389;3177
"5122";23;3;85;34;17367648;17371491;3843
"5222";23;3;37;35;17377394;17381388;3994
"5412";23;1;87;36;17389475;17392130;2655
"5520";23;3;29;37;17395170;17399413;4243
"5713";23;3;1;38;17405367;17409870;4503
"5913";23;1;71;39;17415494;17415812;318
"6019";23;3;45;40;17423140;17427102;3962
"6113";23;1;3;41;17429901;17433336;3435
"6312";23;1;7;42;17439269;17442194;2925
"6521";23;1;35;43;17449244;17452694;3450
"6722";23;1;47;44;17458493;17460896;2403
"6821";23;3;77;45;17463931;17467394;3463
"6922";23;3;25;46;17471481;17476310;4829
"7113";23;3;17;47;17482695;17487018;4323
"7320";23;1;39;48;17658670;17661954;3284
"7522";23;1;19;49;17668093;17671024;2931
"7720";23;1;23;50;17677270;17679620;2350
"7920";23;4;98;51;17684909;17687744;2835
"8020";23;2;84;52;17690375;17693819;3444
"8122";23;4;82;53;17696524;17699819;3295
"8221";23;4;10;54;17702916;17707535;4619
"8421";23;2;92;55;17713446;17716634;3188
"8514";23;2;36;56;17718947;17721176;2229
"8711";23;4;38;57;17726908;17731010;4102
"8911";23;2;8;58;17737348;17740364;3016
"9118";23;4;54;59;17747672;17750292;2620
"9221";23;2;20;60;17753503;17756100;2597
"9422";23;2;48;61;17762180;17764650;2470
"9522";23;2;56;62;17767401;17769941;2540
"9614";23;2;44;63;17773229;17775478;2249
"9720";23;2;24;64;17778635;17780958;2323
"9921";23;2;40;65;17787016;17790239;3223
"10119";23;4;2;66;17797208;17800332;3124
"10318";23;2;72;67;17806714;17810457;3743
"10422";23;2;100;68;17813062;17816115;3053
"10514";23;2;16;69;17818901;17822115;3214
"10718";23;2;52;70;17832536;17835514;2978
"10815";23;4;62;71;17838308;17840647;2339
"10920";23;4;78;72;17843625;17847472;3847
"11012";23;2;96;73;17851021;17852864;1843
"11125";23;2;60;74;17855273;17857636;2363
"11221";23;2;12;75;17860264;17862611;2347
"11421";23;4;26;76;17868081;17871071;2990
"11622";23;4;86;77;17876831;17879763;2932
"11722";23;4;34;78;17883374;17887078;3704
"11922";23;2;68;79;17894919;17898022;3103
"12022";23;2;80;80;17901283;17905045;3762
"12126";23;4;94;81;17911426;17914135;2709
"12224";23;4;66;82;17917800;17921778;3978
"12317";23;4;18;83;17924484;17927720;3236
"12519";23;4;58;84;17935790;17939969;4179
"12615";23;4;6;85;17944816;17948294;3478
"12812";23;2;4;86;17954095;17957369;3274
"13019";23;2;28;87;17963603;17966718;3115
"13216";23;4;22;88;17975487;17978493;3006
"13412";23;2;76;89;17983878;17985955;2077
"13520";23;4;74;90;17988890;17992709;3819
"13612";23;2;88;91;17995670;17998500;2830
"13721";23;4;46;92;18004776;18008356;3580
"13819";23;2;64;93;18011159;18013613;2454
"13922";23;4;42;94;18016866;18020224;3358
"14014";23;4;30;95;18028168;18031911;3743
"14215";23;4;70;96;18039088;18042743;3655
"14321";23;4;50;97;18048211;18054140;5929
"14412";23;4;90;98;18057059;18060960;3901
"14521";23;2;32;99;18064910;18067769;2859
"14721";23;4;14;100;18073808;18077522;3714
"9100";24;4;97;1;20044135;20051556;7421
"10102";24;2;83;2;20057759;20061073;3314
"11102";24;4;81;3;20064235;20071057;6822
"12101";24;4;9;4;20075601;20080081;4480
"1466";24;2;91;5;20085989;20088842;2853
"1512";24;2;35;6;20092067;20097204;5137
"1712";24;4;37;7;20103526;20108579;5053
"1911";24;2;7;8;20115478;20120345;4867
"2112";24;4;53;9;20127547;20132733;5186
"2223";24;2;19;10;20227474;20231450;3976
"2422";24;2;47;11;20237377;20241225;3848
"2522";24;2;55;12;20244921;20251474;6553
"2612";24;2;43;13;20254154;20257845;3691
"2723";24;2;23;14;20260866;20265924;5058
"2921";24;2;39;15;20274786;20278656;3870
"3111";24;4;1;16;20283901;20290298;6397
"3322";24;2;71;17;20296884;20299768;2884
"3422";24;2;99;18;20303247;20309856;6609
"3512";24;2;15;19;20312431;20318114;5683
"3722";24;2;51;20;20324223;20330071;5848
"3812";24;4;61;21;20332680;20340329;7649
"3923";24;4;77;22;20343086;20348362;5276
"4012";24;2;95;23;20351497;20356329;4832
"4123";24;2;59;24;20358545;20361370;2825
"4221";24;2;11;25;20364309;20367303;2994
"4420";24;4;25;26;20375585;20386486;10901
"4621";24;4;85;27;20392010;20402694;10684
"4723";24;4;33;28;20405900;20413760;7860
"4920";24;2;67;29;20419451;20423385;3934
"5023";24;2;79;30;20425663;20428910;3247
"5123";24;4;93;31;20500997;20505830;4833
"5223";24;4;65;32;20508537;20513423;4886
"5312";24;4;17;33;20516023;20519523;3500
"5521";24;4;57;34;20527685;20533922;6237
"5611";24;4;5;35;20536957;20540760;3803
"589";24;2;3;36;20548797;20554321;5524
"6020";24;2;27;37;20560597;20565546;4949
"6210";24;4;21;38;20573791;20579891;6100
"6410";24;2;75;39;20584499;20587996;3497
"6522";24;4;73;40;20590629;20594912;4283
"6612";24;2;87;41;20597694;20600712;3018
"6723";24;4;45;42;20603289;20608372;5083
"6822";24;2;63;43;20611243;20614903;3660
"6923";24;4;41;44;20617529;20621637;4108
"7012";24;4;29;45;20628557;20632944;4387
"7210";24;4;69;46;20640242;20644951;4709
"7321";24;4;49;47;20647733;20652052;4319
"7412";24;4;89;48;20750558;20753326;2768
"7523";24;2;31;49;20756459;20760080;3621
"7721";24;4;13;50;20766721;20772166;5445
"7921";24;3;64;51;20776933;20783383;6450
"8021";24;3;80;52;20785891;20790986;5095
"8123";24;3;44;53;20793770;20798191;4421
"8222";24;3;68;54;20802427;20808690;6263
"8311";24;1;70;55;20812588;20817973;5385
"8422";24;3;12;56;20820611;20826356;5745
"8611";24;1;6;57;20831590;20837723;6133
"8811";24;3;32;58;20842568;20846478;3910
"9011";24;1;22;59;20851795;20854864;3069
"9222";24;3;60;60;20860547;20865038;4491
"9314";24;1;90;61;20867461;20873538;6077
"9423";24;1;66;62;20876190;20881505;5315
"9523";24;1;14;63;20887035;20890363;3328
"9721";24;3;76;64;20896469;20900729;4260
"9811";24;3;84;65;20903603;20909295;5692
"9922";24;3;56;66;20912481;20917953;5472
"10011";24;1;34;67;20923531;20927372;3841
"10215";24;1;82;68;20934379;20937977;3598
"10319";24;1;94;69;20940749;20944661;3912
"10423";24;3;28;70;20947830;20953941;6111
"10613";24;3;92;71;20959782;20965510;5728
"10719";24;3;16;72;20968511;20974493;5982
"10921";24;1;10;73;20981602;20984967;3365
"11126";24;3;96;74;20990684;20995568;4884
"11222";24;1;58;75;20997898;21002275;4377
"11315";24;1;42;76;21005005;21008634;3629
"11422";24;1;50;77;21012611;21016350;3739
"11513";24;1;74;78;21106363;21109080;2717
"11623";24;1;62;79;21111875;21116401;4526
"11723";24;1;98;80;21118799;21123465;4666
"11812";24;1;54;81;21125840;21129137;3297
"11923";24;3;100;82;21132228;21136262;4034
"12023";24;3;52;83;21139233;21144937;5704
"12127";24;1;86;84;21149741;21152745;3004
"12225";24;1;38;85;21156762;21159670;2908
"12413";24;3;88;86;21167243;21171761;4518
"12520";24;1;30;87;21175721;21179027;3306
"12712";24;1;2;88;21187537;21190909;3372
"12911";24;3;72;89;21197148;21201398;4250
"13020";24;1;46;90;21203929;21206610;2681
"13116";24;3;4;91;21211247;21215268;4021
"13312";24;3;8;92;21222169;21225700;3531
"13521";24;3;36;93;21231433;21235433;4000
"13722";24;3;48;94;21241231;21246700;5469
"13820";24;1;78;95;21249228;21253874;4646
"13923";24;1;26;96;21258637;21262674;4037
"14115";24;1;18;97;21269527;21274032;4505
"14322";24;3;40;98;21279417;21284199;4782
"14522";24;3;20;99;21289167;21294477;5310
"14722";24;3;24;100;21300932;21306065;5133
"9101";25;3;63;1;23085417;23093579;8162
"10103";25;3;79;2;23096332;23102420;6088
"11103";25;3;43;3;23104832;23114361;9529
"12102";25;3;67;4;23116851;23122644;5793
"1360";25;1;69;5;23125038;23130586;5548
"1467";25;3;11;6;23134144;23143085;8941
"1611";25;1;5;7;23149829;23155251;5422
"1812";25;3;31;8;23161447;23167435;5988
"2012";25;1;21;9;23172815;23176592;3777
"2224";25;3;59;10;23182335;23187467;5132
"2312";25;1;89;11;23190962;23198325;7363
"2423";25;1;65;12;23200807;23205500;4693
"2523";25;1;13;13;23207972;23213183;5211
"2724";25;3;75;14;23219083;23225449;6366
"2813";25;3;83;15;23227761;23235665;7904
"2922";25;3;55;16;23238002;23247373;9371
"3013";25;1;33;17;23250029;23253998;3969
"3213";25;1;81;18;23259100;23263081;3981
"3323";25;1;93;19;23265364;23272097;6733
"3423";25;3;27;20;23274672;23279622;4950
"3613";25;3;91;21;23284136;23295563;11427
"3723";25;3;15;22;23298416;23302646;4230
"3924";25;1;9;23;23308050;23312196;4146
"4124";25;3;95;24;23319418;23324529;5111
"4222";25;1;57;25;23329304;23334012;4708
"4314";25;1;41;26;23336473;23342429;5956
"4421";25;1;49;27;23344559;23352044;7485
"4514";25;1;73;28;23354830;23358861;4031
"4622";25;1;61;29;23361170;23364220;3050
"4724";25;1;97;30;23367500;23371594;4094
"4814";25;1;53;31;23373970;23377785;3815
"4921";25;3;99;32;23380094;23384535;4441
"5024";25;3;51;33;23386811;23392143;5332
"5124";25;1;85;34;23394688;23399135;4447
"5224";25;1;37;35;23402842;23407593;4751
"5413";25;3;87;36;23412606;23417126;4520
"5522";25;1;29;37;23420308;23425109;4801
"5714";25;1;1;38;23430789;23436050;5261
"5914";25;3;71;39;23442697;23449033;6336
"6021";25;1;45;40;23451309;23455533;4224
"6114";25;3;3;41;23458085;23462474;4389
"6313";25;3;7;42;23468853;23473665;4812
"6523";25;3;35;43;23479994;23486056;6062
"6724";25;3;47;44;23491094;23495489;4395
"6823";25;1;77;45;23499705;23504098;4393
"6924";25;1;25;46;23506508;23510981;4473
"7114";25;1;17;47;23516500;23520747;4247
"7322";25;3;39;48;23526218;23532747;6529
"7524";25;3;19;49;23615969;23621110;5141
"7722";25;3;23;50;23627872;23633010;5138
"7922";25;2;98;51;23676581;23680399;3818
"8022";25;4;84;52;23682930;23689450;6520
"8124";25;2;82;53;23692520;23695166;2646
"8223";25;2;10;54;23697447;23702216;4769
"8423";25;4;92;55;23709893;23718690;8797
"8515";25;4;36;56;23721287;23725615;4328
"8712";25;2;38;57;23731522;23735065;3543
"8912";25;4;8;58;23744237;23748131;3894
"9119";25;2;54;59;23753263;23755947;2684
"9223";25;4;20;60;23761586;23765447;3861
"9424";25;4;48;61;23771220;23777221;6001
"9524";25;4;56;62;23780469;23785379;4910
"9615";25;4;44;63;23791224;23796329;5105
"9722";25;4;24;64;23798869;23804586;5717
"9923";25;4;40;65;23811447;23815153;3706
"10120";25;2;2;66;23823635;23831203;7568
"10320";25;4;72;67;23837478;23843028;5550
"10424";25;4;100;68;23845994;23849594;3600
"10515";25;4;16;69;23855135;23858785;3650
"10720";25;4;52;70;23868287;23879743;11456
"10816";25;2;62;71;23882567;23885834;3267
"10922";25;2;78;72;23890046;23894692;4646
"11013";25;4;96;73;23900301;23904909;4608
"11127";25;4;60;74;23910369;23916092;5723
"11223";25;4;12;75;23918964;23922533;3569
"11423";25;2;26;76;23931427;23935049;3622
"11624";25;2;86;77;23940891;23943782;2891
"11724";25;2;34;78;23946261;23948882;2621
"11924";25;4;68;79;23954202;23957707;3505
"12024";25;4;80;80;23962077;23970306;8229
"12128";25;2;94;81;23974410;23978231;3821
"12226";25;2;66;82;23982736;23987839;5103
"12318";25;2;18;83;23993299;23998255;4956
"12521";25;2;58;84;24008408;24016063;7655
"12616";25;2;6;85;24018599;24026488;7889
"12813";25;4;4;86;24032283;24035721;3438
"13021";25;4;28;87;24041136;24045504;4368
"13217";25;2;22;88;24050674;24053120;2446
"13413";25;4;76;89;24059308;24062811;3503
"13522";25;2;74;90;24068070;24071886;3816
"13613";25;4;88;91;24075505;24079619;4114
"13723";25;2;46;92;24087950;24091761;3811
"13821";25;4;64;93;24103792;24109993;6201
"13924";25;2;42;94;24271434;24275431;3997
"14015";25;2;30;95;24278805;24283147;4342
"14216";25;2;70;96;24295022;24301538;6516
"14323";25;2;50;97;24310048;24317604;7556
"14413";25;2;90;98;24351535;24355653;4118
"14523";25;4;32;99;24359088;24364086;4998
"14723";25;2;14;100;24372328;24376311;3983
"9102";26;2;97;1;1484982;1489203;4221
"10104";26;4;83;2;1491778;1495819;4041
"11104";26;2;81;3;1498132;1502043;3911
"12103";26;2;9;4;1504621;1507810;3189
"1468";26;4;91;5;1514446;1518710;4264
"1513";26;4;35;6;1521067;1524793;3726
"1713";26;2;37;7;1531226;1534501;3275
"1912";26;4;7;8;1541080;1545959;4879
"2113";26;2;53;9;1552536;1555942;3406
"2225";26;4;19;10;1558329;1562600;4271
"2424";26;4;47;11;1568148;1571725;3577
"2524";26;4;55;12;1574449;1578383;3934
"2613";26;4;43;13;1580728;1585049;4321
"2725";26;4;23;14;1588472;1592599;4127
"2923";26;4;39;15;1598005;1602073;4068
"3112";26;2;1;16;1607458;1611423;3965
"3324";26;4;71;17;1618074;1622189;4115
"3424";26;4;99;18;1624648;1628289;3641
"3513";26;4;15;19;1631342;1635414;4072
"3724";26;4;51;20;1641539;1645605;4066
"3813";26;2;61;21;1648121;1651646;3525
"3925";26;2;77;22;1654249;1657038;2789
"4013";26;4;95;23;1660414;1664055;3641
"4125";26;4;59;24;1666884;1670113;3229
"4223";26;4;11;25;1672764;1676629;3865
"4422";26;2;25;26;1681936;1684921;2985
"4623";26;2;85;27;1690769;1693703;2934
"4725";26;2;33;28;1696358;1698687;2329
"4922";26;4;67;29;1703462;1707320;3858
"5025";26;4;79;30;1709719;1713145;3426
"5125";26;2;93;31;1715709;1718353;2644
"5225";26;2;65;32;1722155;1724719;2564
"5313";26;2;17;33;1727590;1730219;2629
"5523";26;2;57;34;1736084;1739652;3568
"5612";26;2;5;35;1743111;1745818;2707
"5810";26;4;3;36;1751452;1755018;3566
"6022";26;4;27;37;1760509;1763976;3467
"6211";26;2;21;38;1768696;1771317;2621
"6411";26;4;75;39;1777003;1780975;3972
"6524";26;2;73;40;1783938;1787200;3262
"6613";26;4;87;41;1789953;1793025;3072
"6725";26;2;45;42;1795416;1798141;2725
"6824";26;4;63;43;1800816;1804425;3609
"6925";26;2;41;44;1807187;1809833;2646
"7013";26;2;29;45;1812753;1815557;2804
"7211";26;2;69;46;1821301;1825082;3781
"7323";26;2;49;47;1828119;1830857;2738
"7413";26;2;89;48;1833249;1835665;2416
"7525";26;4;31;49;1838043;1842982;4939
"7723";26;2;13;50;1901260;1904579;3319
"7923";26;1;64;51;1910287;1913829;3542
"8023";26;1;80;52;1916589;1920037;3448
"8125";26;1;44;53;2016754;2020284;3530
"8224";26;1;68;54;2022943;2026867;3924
"8312";26;3;70;55;2029502;2034400;4898
"8424";26;1;12;56;2036928;2040400;3472
"8612";26;3;6;57;2046860;2050383;3523
"8812";26;1;32;58;2056187;2059574;3387
"9012";26;3;22;59;2064953;2068799;3846
"9224";26;1;60;60;2074707;2077715;3008
"9315";26;3;90;61;2080338;2084790;4452
"9425";26;3;66;62;2087527;2091873;4346
"9525";26;3;14;63;2094389;2098522;4133
"9723";26;1;76;64;2106109;2108297;2188
"9812";26;1;84;65;2111861;2114847;2986
"9924";26;1;56;66;2117307;2119514;2207
"10012";26;3;34;67;2123403;2126296;2893
"10216";26;3;82;68;2132078;2135021;2943
"10321";26;3;94;69;2138888;2141746;2858
"10425";26;1;28;70;2145348;2147904;2556
"10614";26;1;92;71;2154405;2157204;2799
"10721";26;1;16;72;2160637;2163562;2925
"10923";26;3;10;73;2172629;2177128;4499
"11128";26;1;96;74;2183413;2186620;3207
"11224";26;3;58;75;2189441;2194294;4853
"11316";26;3;42;76;2200342;2204627;4285
"11424";26;3;50;77;2207753;2211085;3332
"11514";26;3;74;78;2214448;2217960;3512
"11625";26;3;62;79;2220896;2223293;2397
"11725";26;3;98;80;2226355;2229009;2654
"11813";26;3;54;81;2234057;2236626;2569
"11925";26;1;100;82;2239811;2242267;2456
"12025";26;1;52;83;2247938;2250575;2637
"12129";26;3;86;84;2386301;2389554;3253
"12227";26;3;38;85;2392369;2395912;3543
"12414";26;1;88;86;2401096;2403595;2499
"12522";26;3;30;87;2406156;2409320;3164
"12713";26;3;2;88;2415204;2418811;3607
"12912";26;1;72;89;2424429;2428102;3673
"13022";26;3;46;90;2430455;2434777;4322
"13117";26;1;4;91;2437134;2439919;2785
"13313";26;1;8;92;2445588;2448351;2763
"13523";26;1;36;93;2453362;2456884;3522
"13724";26;1;48;94;2462420;2465309;2889
"13822";26;3;78;95;2468262;2471684;3422
"13925";26;3;26;96;2474641;2478434;3793
"14116";26;3;18;97;2484988;2488417;3429
"14324";26;1;40;98;2495079;2498274;3195
"14524";26;1;20;99;2504936;2507849;2913
"14724";26;1;24;100;2513369;2516141;2772
"9103";27;1;63;1;4015724;4022337;6613
"10105";27;1;79;2;4024981;4029862;4881
"11105";27;1;43;3;4032077;4038820;6743
"12104";27;1;67;4;4041379;4050031;8652
"1370";27;3;69;5;4052387;4060720;8333
"1469";27;1;11;6;4062997;4067836;4839
"1612";27;3;5;7;4073771;4081177;7406
"1813";27;1;31;8;4086929;4091835;4906
"2013";27;3;21;9;4099109;4104796;5687
"2226";27;1;59;10;4110552;4114418;3866
"2313";27;3;89;11;4117858;4124341;6483
"2425";27;3;65;12;4129827;4135213;5386
"2525";27;3;13;13;4137925;4144669;6744
"2726";27;1;75;14;4150001;4157658;7657
"2814";27;1;83;15;4160036;4163432;3396
"2924";27;1;55;16;4165477;4169903;4426
"3014";27;3;33;17;4172401;4177774;5373
"3214";27;3;81;18;4184093;4190023;5930
"3325";27;3;93;19;4192107;4198673;6566
"3425";27;1;27;20;4201207;4205373;4166
"3614";27;1;91;21;4210237;4213938;3701
"3725";27;1;15;22;4218037;4222347;4310
"3926";27;3;9;23;4227879;4232872;4993
"4126";27;1;95;24;4237686;4241513;3827
"4224";27;3;57;25;4243801;4248238;4437
"4315";27;3;41;26;4250834;4256687;5853
"4423";27;3;49;27;4258950;4265795;6845
"4515";27;3;73;28;4268127;4272720;4593
"4624";27;3;61;29;4275120;4280353;5233
"4726";27;3;97;30;4283013;4289053;6040
"4815";27;3;53;31;4292345;4297203;4858
"4923";27;1;99;32;4299717;4303969;4252
"5026";27;1;51;33;4306713;4310912;4199
"5126";27;3;85;34;4313121;4318777;5656
"5226";27;3;37;35;4321098;4327193;6095
"5414";27;1;87;36;4332769;4336001;3232
"5524";27;3;29;37;4338386;4343301;4915
"5715";27;3;1;38;4348770;4353363;4593
"5915";27;1;71;39;4358752;4361772;3020
"6023";27;3;45;40;4364295;4368159;3864
"6115";27;1;3;41;4370375;4373805;3430
"6314";27;1;7;42;4378730;4381858;3128
"6525";27;1;35;43;4388032;4391991;3959
"6726";27;1;47;44;4400073;4403316;3243
"6825";27;3;77;45;4406580;4411299;4719
"6926";27;3;25;46;4413560;4418343;4783
"7115";27;3;17;47;4424134;4428423;4289
"7324";27;1;39;48;4433074;4435964;2890
"7526";27;1;19;49;4440841;4443906;3065
"7724";27;1;23;50;4449840;4452747;2907
"7924";27;4;98;51;4457193;4460855;3662
"8024";27;2;84;52;4463206;4466913;3707
"8126";27;4;82;53;4470790;4474476;3686
"8225";27;4;10;54;4476730;4481044;4314
"8425";27;2;92;55;4487410;4491696;4286
"8516";27;2;36;56;4494205;4497685;3480
"8713";27;4;38;57;4503790;4508287;4497
"8913";27;2;8;58;4513728;4517062;3334
"9120";27;4;54;59;4522259;4525639;3380
"9225";27;2;20;60;4528154;4530615;2461
"9426";27;2;48;61;4535321;4537936;2615
"9526";27;2;56;62;4540313;4542794;2481
"9616";27;2;44;63;4545110;4547719;2609
"9724";27;2;24;64;4550032;4552952;2920
"9925";27;2;40;65;4558107;4560097;1990
"10121";27;4;2;66;4564823;4568568;3745
"10322";27;2;72;67;4574696;4578685;3989
"10426";27;2;100;68;4580924;4583584;2660
"10516";27;2;16;69;4586105;4589384;3279
"10722";27;2;52;70;4594977;4598842;3865
"10817";27;4;62;71;4600989;4604292;3303
"10924";27;4;78;72;4606560;4610373;3813
"11014";27;2;96;73;4613254;4615658;2404
"11129";27;2;60;74;4618152;4620893;2741
"11225";27;2;12;75;4623302;4626741;3439
"11425";27;4;26;76;4632077;4635424;3347
"11626";27;4;86;77;4640069;4643174;3105
"11726";27;4;34;78;4645881;4650255;4374
"11926";27;2;68;79;4655425;4658573;3148
"12026";27;2;80;80;4661261;4664198;2937
"12130";27;4;94;81;4666268;4670120;3852
"12228";27;4;66;82;4672850;4676393;3543
"12319";27;4;18;83;4678828;4682570;3742
"12523";27;4;58;84;4689063;4693439;4376
"12617";27;4;6;85;4696113;4699630;3517
"12814";27;2;4;86;4705385;4707947;2562
"13023";27;2;28;87;4712333;4716488;4155
"13218";27;4;22;88;4721482;4724988;3506
"13414";27;2;76;89;4730634;4732846;2212
"13524";27;4;74;90;4735104;4738429;3325
"13614";27;2;88;91;4740540;4743637;3097
"13725";27;4;46;92;4746240;4750133;3893
"13823";27;2;64;93;4752736;4755445;2709
"13926";27;4;42;94;4757813;4762534;4721
"14016";27;4;30;95;4765239;4768611;3372
"14217";27;4;70;96;4773851;4779011;5160
"14325";27;4;50;97;4783432;4787652;4220
"14414";27;4;90;98;4789860;4793952;4092
"14525";27;2;32;99;4796001;4799260;3259
"14725";27;4;14;100;4804652;4809110;4458
"9104";28;4;97;1;2993039;2999407;6368
"10106";28;2;83;2;3002004;3005848;3844
"11106";28;4;81;3;3008405;3013948;5543
"12105";28;4;9;4;3016252;3021939;5687
"1470";28;2;91;5;3027535;3032106;4571
"1514";28;2;35;6;3034505;3039714;5209
"1714";28;4;37;7;3045623;3051005;5382
"1913";28;2;7;8;3057029;3060829;3800
"2114";28;4;53;9;3068070;3074371;6301
"2227";28;2;19;10;3076667;3080954;4287
"2426";28;2;47;11;3086304;3091320;5016
"2526";28;2;55;12;3093578;3097712;4134
"2614";28;2;43;13;3100018;3103828;3810
"2727";28;2;23;14;3106265;3110819;4554
"2925";28;2;39;15;3116523;3120369;3846
"3113";28;4;1;16;3126795;3132685;5890
"3326";28;2;71;17;3138947;3142935;3988
"3426";28;2;99;18;3145408;3149418;4010
"3514";28;2;15;19;3151713;3157651;5938
"3726";28;2;51;20;3163723;3168234;4511
"3814";28;4;61;21;3170513;3175609;5096
"3927";28;4;77;22;3177906;3182425;4519
"4014";28;2;95;23;3184752;3188800;4048
"4127";28;2;59;24;3191096;3194300;3204
"4225";28;2;11;25;3196585;3201150;4565
"4424";28;4;25;26;3207429;3212066;4637
"4625";28;4;85;27;3217524;3223207;5683
"4727";28;4;33;28;3225616;3230699;5083
"4924";28;2;67;29;3235959;3241506;5547
"5027";28;2;79;30;3243801;3247356;3555
"5127";28;4;93;31;3249739;3256748;7009
"5227";28;4;65;32;3259142;3265072;5930
"5314";28;4;17;33;3267557;3272989;5432
"5525";28;4;57;34;3277868;3281880;4012
"5613";28;4;5;35;3284322;3289405;5083
"5811";28;2;3;36;3296162;3300146;3984
"6024";28;2;27;37;3306587;3311262;4675
"6212";28;4;21;38;3316338;3321195;4857
"6412";28;2;75;39;3327906;3334094;6188
"6526";28;4;73;40;3336351;3341786;5435
"6614";28;2;87;41;3344147;3349036;4889
"6727";28;4;45;42;3351479;3356361;4882
"6826";28;2;63;43;3358686;3362269;3583
"6927";28;4;41;44;3364662;3369052;4390
"7014";28;4;29;45;3371477;3378143;6666
"7212";28;4;69;46;3384007;3390084;6077
"7325";28;4;49;47;3392632;3397684;5052
"7414";28;4;89;48;3489489;3493266;3777
"7527";28;2;31;49;3497548;3502700;5152
"7725";28;4;13;50;3510654;3515941;5287
"7925";28;3;64;51;3526182;3532332;6150
"8025";28;3;80;52;3606472;3613196;6724
"8127";28;3;44;53;3615402;3622212;6810
"8226";28;3;68;54;3624777;3630387;5610
"8313";28;1;70;55;3633408;3638812;5404
"8426";28;3;12;56;3641341;3648395;7054
"8613";28;1;6;57;3653897;3659002;5105
"8813";28;3;32;58;3664515;3670344;5829
"9013";28;1;22;59;3676496;3681535;5039
"9226";28;3;60;60;3687538;3694285;6747
"9316";28;1;90;61;3696567;3701476;4909
"9427";28;1;66;62;3703882;3709109;5227
"9527";28;1;14;63;3711471;3716217;4746
"9725";28;3;76;64;3721792;3727008;5216
"9813";28;3;84;65;3729314;3738875;9561
"9926";28;3;56;66;3741155;3745624;4469
"10013";28;1;34;67;3748095;3753174;5079
"10217";28;1;82;68;3759010;3762949;3939
"10323";28;1;94;69;3765169;3769982;4813
"10427";28;3;28;70;3772335;3779440;7105
"10615";28;3;92;71;3786346;3793047;6701
"10723";28;3;16;72;3795728;3803481;7753
"10925";28;1;10;73;3809045;3813230;4185
"11130";28;3;96;74;3820028;3824855;4827
"11226";28;1;58;75;3827299;3831171;3872
"11317";28;1;42;76;3833624;3838338;4714
"11426";28;1;50;77;3840628;3845221;4593
"11515";28;1;74;78;3847693;3851454;3761
"11627";28;1;62;79;3853878;3857837;3959
"11727";28;1;98;80;3860019;3863870;3851
"11814";28;1;54;81;3866046;3870028;3982
"11927";28;3;100;82;3872245;3877620;5375
"12027";28;3;52;83;3880754;3886569;5815
"12131";28;1;86;84;3888904;3892377;3473
"12229";28;1;38;85;3894772;3898969;4197
"12415";28;3;88;86;3904229;3910735;6506
"12524";28;1;30;87;3912968;3916551;3583
"12714";28;1;2;88;3922595;3927635;5040
"12913";28;3;72;89;3933415;3940917;7502
"13024";28;1;46;90;3943249;3947509;4260
"13118";28;3;4;91;3950520;3955800;5280
"13314";28;3;8;92;3962326;3968441;6115
"13525";28;3;36;93;3974657;3980532;5875
"13726";28;3;48;94;3986756;3993415;6659
"13824";28;1;78;95;3995898;4000807;4909
"13927";28;1;26;96;4003191;4007315;4124
"14117";28;1;18;97;4012929;4016965;4036
"14326";28;3;40;98;4022822;4026914;4092
"14526";28;3;20;99;4032159;4037030;4871
"14726";28;3;24;100;4042153;4048005;5852
"9105";29;3;63;1;4367915;4374719;6804
"10107";29;3;79;2;4377136;4383385;6249
"11107";29;3;43;3;4385898;4393218;7320
"12106";29;3;67;4;4395501;4403393;7892
"1380";29;1;69;5;4405687;4412409;6722
"1480";29;3;11;6;4414833;4422808;7975
"1613";29;1;5;7;4429926;4435491;5565
"1814";29;3;31;8;4443282;4451132;7850
"2014";29;1;21;9;4458678;4465749;7071
"2228";29;3;59;10;4471941;4478415;6474
"2314";29;1;89;11;4480625;4486256;5631
"2427";29;1;65;12;4488649;4498572;9923
"2527";29;1;13;13;4502908;4509039;6131
"2728";29;3;75;14;4516198;4524105;7907
"2815";29;3;83;15;4526648;4533196;6548
"2926";29;3;55;16;4535573;4541679;6106
"3015";29;1;33;17;4543978;4550429;6451
"3215";29;1;81;18;4556013;4561620;5607
"3327";29;1;93;19;4564318;4570053;5735
"3427";29;3;27;20;4572385;4580853;8468
"3615";29;3;91;21;4586469;4593627;7158
"3727";29;3;15;22;4595863;4602560;6697
"3928";29;1;9;23;4609176;4614460;5284
"4128";29;3;95;24;4623351;4630559;7208
"4226";29;1;57;25;4632849;4637776;4927
"4316";29;1;41;26;4640126;4644950;4824
"4425";29;1;49;27;4647190;4652375;5185
"4516";29;1;73;28;4654915;4660566;5651
"4626";29;1;61;29;4662788;4668458;5670
"4728";29;1;97;30;4671204;4676574;5370
"4816";29;1;53;31;4678759;4684124;5365
"4925";29;3;99;32;4686519;4693907;7388
"5028";29;3;51;33;4696385;4702782;6397
"5128";29;1;85;34;4705344;4710264;4920
"5228";29;1;37;35;4712829;4717947;5118
"5415";29;3;87;36;4724074;4729656;5582
"5526";29;1;29;37;4732007;4737681;5674
"5716";29;1;1;38;4743946;4749072;5126
"5916";29;3;71;39;4755392;4761304;5912
"6025";29;1;45;40;4763720;4768071;4351
"6116";29;3;3;41;4770324;4777004;6680
"6315";29;3;7;42;4783117;4790628;7511
"6527";29;3;35;43;4799859;4806278;6419
"6728";29;3;47;44;4815036;4821477;6441
"6827";29;1;77;45;4823596;4829035;5439
"6928";29;1;25;46;4832519;4839435;6916
"7116";29;1;17;47;4848282;4853743;5461
"7326";29;3;39;48;4907764;4914924;7160
"7528";29;3;19;49;4920937;4928323;7386
"7726";29;3;23;50;4934196;4941681;7485
"7926";29;2;98;51;4947193;4951473;4280
"8026";29;4;84;52;4955271;4962030;6759
"8128";29;2;82;53;4964559;4970080;5521
"8227";29;2;10;54;4974871;4980188;5317
"8427";29;4;92;55;5034703;5041906;7203
"8517";29;4;36;56;5044651;5049931;5280
"8714";29;2;38;57;5056386;5061080;4694
"8914";29;4;8;58;5066934;5072829;5895
"9121";29;2;54;59;5080116;5084187;4071
"9227";29;4;20;60;5086591;5091687;5096
"9428";29;4;48;61;5098272;5104961;6689
"9528";29;4;56;62;5107463;5113195;5732
"9617";29;4;44;63;5115716;5122011;6295
"9726";29;4;24;64;5124422;5131152;6730
"9927";29;4;40;65;5137222;5141410;4188
"10122";29;2;2;66;5147082;5151885;4803
"10324";29;4;72;67;5159541;5167426;7885
"10428";29;4;100;68;5169830;5175326;5496
"10517";29;4;16;69;5178254;5184242;5988
"10724";29;4;52;70;5190801;5198525;7724
"10818";29;2;62;71;5201069;5205366;4297
"10926";29;2;78;72;5207595;5211991;4396
"11015";29;4;96;73;5214621;5219449;4828
"11131";29;4;60;74;5222377;5227082;4705
"11227";29;4;12;75;5229552;5234599;5047
"11427";29;2;26;76;5240681;5246682;6001
"11628";29;2;86;77;5252565;5256748;4183
"11728";29;2;34;78;5259245;5264781;5536
"11928";29;4;68;79;5271877;5277364;5487
"12028";29;4;80;80;5279833;5286263;6430
"12132";29;2;94;81;5288933;5293938;5005
"12230";29;2;66;82;5296598;5301779;5181
"12320";29;2;18;83;5304578;5308921;4343
"12525";29;2;58;84;5314502;5319545;5043
"12618";29;2;6;85;5321835;5326087;4252
"12815";29;4;4;86;5331980;5338253;6273
"13025";29;4;28;87;5343954;5350611;6657
"13219";29;2;22;88;5357283;5360819;3536
"13415";29;4;76;89;5366720;5372368;5648
"13526";29;2;74;90;5374584;5379268;4684
"13615";29;4;88;91;5382090;5389235;7145
"13727";29;2;46;92;5391939;5395909;3970
"13825";29;4;64;93;5398115;5403734;5619
"13928";29;2;42;94;5406243;5410767;4524
"14017";29;2;30;95;5413420;5417508;4088
"14218";29;2;70;96;5423668;5428825;5157
"14327";29;2;50;97;5431481;5436733;5252
"14415";29;2;90;98;5439359;5443974;4615
"14527";29;4;32;99;5446788;5452765;5977
"14727";29;2;14;100;5458738;5463157;4419
"9106";30;2;97;1;5858960;5864587;5627
"10108";30;4;83;2;5867146;5871678;4532
"11108";30;2;81;3;5874059;5879828;5769
"12107";30;2;9;4;5881999;5885728;3729
"1482";30;4;91;5;5891545;5896902;5357
"1515";30;4;35;6;5899326;5905436;6110
"1715";30;2;37;7;5913393;5919235;5842
"1914";30;4;7;8;5924569;5931785;7216
"2115";30;2;53;9;5939800;5943009;3209
"2229";30;4;19;10;5945473;5951017;5544
"2428";30;4;47;11;5956638;5961742;5104
"2528";30;4;55;12;5964410;5968917;4507
"2615";30;4;43;13;5971519;5978433;6914
"2729";30;4;23;14;5981307;5985891;4584
"2927";30;4;39;15;5993968;5999249;5281
"3114";30;2;1;16;6004573;6008832;4259
"3328";30;4;71;17;6019451;6024898;5447
"3428";30;4;99;18;6027150;6032439;5289
"3515";30;4;15;19;6034691;6038931;4240
"3728";30;4;51;20;6044624;6051780;7156
"3815";30;2;61;21;6053905;6058947;5042
"3929";30;2;77;22;6061197;6065446;4249
"4015";30;4;95;23;6067641;6079246;11605
"4129";30;4;59;24;6081736;6085662;3926
"4227";30;4;11;25;6087798;6093687;5889
"4426";30;2;25;26;6098659;6102703;4044
"4627";30;2;85;27;6108119;6112395;4276
"4729";30;2;33;28;6114657;6117936;3279
"4926";30;4;67;29;6123913;6129194;5281
"5029";30;4;79;30;6131589;6137919;6330
"5129";30;2;93;31;6139971;6146077;6106
"5229";30;2;65;32;6149060;6153201;4141
"5315";30;2;17;33;6155932;6160351;4419
"5527";30;2;57;34;6167534;6170784;3250
"5614";30;2;5;35;6173267;6176617;3350
"5812";30;4;3;36;6182079;6189867;7788
"6026";30;4;27;37;6195251;6202841;7590
"6213";30;2;21;38;6207927;6212799;4872
"6413";30;4;75;39;6218793;6224241;5448
"6528";30;2;73;40;6226887;6231082;4195
"6615";30;4;87;41;6233414;6238774;5360
"6729";30;2;45;42;6241223;6243957;2734
"6828";30;4;63;43;6246340;6251489;5149
"6929";30;2;41;44;6253675;6257656;3981
"7015";30;2;29;45;6259961;6264639;4678
"7213";30;2;69;46;6270374;6279555;9181
"7327";30;2;49;47;6282248;6286113;3865
"7415";30;2;89;48;6359558;6363622;4064
"7529";30;4;31;49;6366033;6372613;6580
"7727";30;2;13;50;6379992;6383513;3521
"7927";30;1;64;51;6389626;6397712;8086
"8027";30;1;80;52;6400304;6405554;5250
"8129";30;1;44;53;6407784;6411695;3911
"8228";30;1;68;54;6413967;6420445;6478
"8314";30;3;70;55;6455868;6462810;6942
"8428";30;1;12;56;6465545;6470293;4748
"8614";30;3;6;57;6476121;6481726;5605
"8814";30;1;32;58;6487243;6491617;4374
"9014";30;3;22;59;6497792;6504008;6216
"9228";30;1;60;60;6510014;6515783;5769
"9317";30;3;90;61;6518448;6524624;6176
"9429";30;3;66;62;6527233;6534674;7441
"9529";30;3;14;63;6537276;6545157;7881
"9727";30;1;76;64;6550634;6554982;4348
"9814";30;1;84;65;6557313;6562273;4960
"9928";30;1;56;66;6564536;6569506;4970
"10014";30;3;34;67;6571958;6579156;7198
"10218";30;3;82;68;6585430;6590847;5417
"10325";30;3;94;69;6593356;6601213;7857
"10429";30;1;28;70;6603418;6611296;7878
"10616";30;1;92;71;6617358;6623271;5913
"10725";30;1;16;72;6625748;6632304;6556
"10927";30;3;10;73;6640600;6647979;7379
"11132";30;1;96;74;6657580;6661778;4198
"11228";30;3;58;75;6664220;6671294;7074
"11318";30;3;42;76;6673559;6679044;5485
"11428";30;3;50;77;6681646;6688110;6464
"11516";30;3;74;78;6690354;6696610;6256
"11629";30;3;62;79;6699084;6705459;6375
"11729";30;3;98;80;6707652;6713718;6066
"11815";30;3;54;81;6716167;6721242;5075
"11929";30;1;100;82;6723389;6728942;5553
"12029";30;1;52;83;6730995;6736367;5372
"12133";30;3;86;84;6738847;6744275;5428
"12231";30;3;38;85;6746336;6753008;6672
"12416";30;1;88;86;6758701;6766066;7365
"12526";30;3;30;87;6768432;6774057;5625
"12715";30;3;2;88;6779579;6788365;8786
"12914";30;1;72;89;6794312;6800673;6361
"13026";30;3;46;90;6802886;6808764;5878
"13119";30;1;4;91;6811034;6815922;4888
"13315";30;1;8;92;6821978;6827138;5160
"13527";30;1;36;93;6832383;6837171;4788
"13728";30;1;48;94;6842883;6847929;5046
"13826";30;3;78;95;6850165;6857904;7739
"13929";30;3;26;96;6860396;6867770;7374
"14118";30;3;18;97;6873522;6880878;7356
"14328";30;1;40;98;6887223;6892753;5530
"14528";30;1;20;99;6898113;6902977;4864
"14728";30;1;24;100;6908635;6913369;4734
"9107";31;1;63;1;1403580;1406936;3356
"10109";31;1;79;2;1409574;1412436;2862
"11109";31;1;43;3;1415264;1418919;3655
"12108";31;1;67;4;1421070;1425393;4323
"1390";31;3;69;5;1427914;1433785;5871
"1483";31;1;11;6;1435912;1440032;4120
"1614";31;3;5;7;1446838;1453376;6538
"1815";31;1;31;8;1462246;1466730;4484
"2015";31;3;21;9;1472200;1479425;7225
"2230";31;1;59;10;1486404;1490283;3879
"2315";31;3;89;11;1492948;1498416;5468
"2429";31;3;65;12;1500983;1510490;9507
"2529";31;3;13;13;1512718;1517196;4478
"2730";31;1;75;14;1523695;1528857;5162
"2816";31;1;83;15;1531460;1534790;3330
"2928";31;1;55;16;1537056;1540681;3625
"3016";31;3;33;17;1542908;1547183;4275
"3216";31;3;81;18;1552168;1557789;5621
"3329";31;3;93;19;1559988;1565355;5367
"3429";31;1;27;20;1567833;1571338;3505
"3616";31;1;91;21;1576340;1582376;6036
"3729";31;1;15;22;1584704;1589913;5209
"3930";31;3;9;23;1595252;1598970;3718
"4130";31;1;95;24;1604032;1608562;4530
"4228";31;3;57;25;1610756;1616884;6128
"4317";31;3;41;26;1619458;1625211;5753
"4427";31;3;49;27;1627711;1633336;5625
"4517";31;3;73;28;1636581;1642336;5755
"4628";31;3;61;29;1645539;1649336;3797
"4730";31;3;97;30;1652742;1657869;5127
"4817";31;3;53;31;1661890;1667851;5961
"4927";31;1;99;32;1669991;1674118;4127
"5030";31;1;51;33;1679092;1682818;3726
"5130";31;3;85;34;1685483;1690917;5434
"5230";31;3;37;35;1693622;1698859;5237
"5416";31;1;87;36;1707189;1710337;3148
"5528";31;3;29;37;1712785;1718586;5801
"5717";31;3;1;38;1724496;1730366;5870
"5917";31;1;71;39;1738169;1741492;3323
"6027";31;3;45;40;1744028;1749498;5470
"6117";31;1;3;41;1752286;1755623;3337
"6316";31;1;7;42;1762872;1769606;6734
"6529";31;1;35;43;1775973;1783118;7145
"6730";31;1;47;44;1791816;1801239;9423
"6829";31;3;77;45;1887976;1892952;4976
"6930";31;3;25;46;1901973;1906654;4681
"7117";31;3;17;47;1912273;1917201;4928
"7328";31;1;39;48;1984278;1986776;2498
"7530";31;1;19;49;1992342;1997001;4659
"7728";31;1;23;50;2002390;2005692;3302
"7928";31;4;98;51;2010452;2015275;4823
"8028";31;2;84;52;2017678;2022717;5039
"8130";31;4;82;53;2025200;2028346;3146
"8229";31;4;10;54;2030574;2034749;4175
"8429";31;2;92;55;2044566;2049292;4726
"8518";31;2;36;56;2051496;2053749;2253
"8715";31;4;38;57;2059329;2063331;4002
"8915";31;2;8;58;2068554;2072906;4352
"9122";31;4;54;59;2080493;2083981;3488
"9229";31;2;20;60;2086106;2089147;3041
"9430";31;2;48;61;2094716;2098222;3506
"9530";31;2;56;62;2100433;2103150;2717
"9618";31;2;44;63;2105705;2109213;3508
"9728";31;2;24;64;2111801;2115455;3654
"9929";31;2;40;65;2120956;2123104;2148
"10123";31;4;2;66;2127970;2132587;4617
"10326";31;2;72;67;2138574;2144353;5779
"10430";31;2;100;68;2146924;2149609;2685
"10518";31;2;16;69;2151827;2155303;3476
"10726";31;2;52;70;2161122;2165886;4764
"10819";31;4;62;71;2168510;2171211;2701
"10928";31;4;78;72;2173430;2177875;4445
"11016";31;2;96;73;2180097;2183027;2930
"11133";31;2;60;74;2185231;2187585;2354
"11229";31;2;12;75;2189800;2193344;3544
"11429";31;4;26;76;2198958;2203918;4960
"11630";31;4;86;77;2209437;2214246;4809
"11730";31;4;34;78;2216626;2220568;3942
"11930";31;2;68;79;2226207;2229267;3060
"12030";31;2;80;80;2231408;2235992;4584
"12134";31;4;94;81;2238598;2242400;3802
"12232";31;4;66;82;2244730;2249133;4403
"12321";31;4;18;83;2251956;2254941;2985
"12527";31;4;58;84;2260566;2265558;4992
"12619";31;4;6;85;2466215;2470300;4085
"12816";31;2;4;86;2475488;2480099;4611
"13027";31;2;28;87;2484896;2489258;4362
"13220";31;4;22;88;2495275;2500407;5132
"13416";31;2;76;89;2505478;2508749;3271
"13528";31;4;74;90;2511535;2515794;4259
"13616";31;2;88;91;2518146;2522356;4210
"13729";31;4;46;92;2524590;2528939;4349
"13827";31;2;64;93;2531579;2535114;3535
"13930";31;4;42;94;2537442;2541106;3664
"14018";31;4;30;95;2543530;2548265;4735
"14219";31;4;70;96;2554473;2558173;3700
"14329";31;4;50;97;2560416;2564781;4365
"14416";31;4;90;98;2567051;2570688;3637
"14529";31;2;32;99;2572893;2577455;4562
"14729";31;4;14;100;2582661;2586962;4301
"9108";32;4;97;1;716352;720343;3991
"10124";32;2;83;2;723988;726976;2988
"11134";32;4;81;3;731761;735215;3454
"12109";32;4;9;4;741806;745017;3211
"1484";32;2;91;5;753731;756700;2969
"1516";32;2;35;6;760035;763166;3131
"1716";32;4;37;7;770300;773746;3446
"1915";32;2;7;8;779822;782026;2204
"2116";32;4;53;9;788650;791610;2960
"2231";32;2;19;10;795452;798508;3056
"2430";32;2;47;11;805334;808356;3022
"2530";32;2;55;12;813274;816364;3090
"2616";32;2;43;13;821152;824056;2904
"2731";32;2;23;14;827620;830547;2927
"2929";32;2;39;15;841664;845822;4158
"3115";32;4;1;16;852071;857431;5360
"3330";32;2;71;17;865724;868937;3213
"3430";32;2;99;18;871342;874279;2937
"3516";32;2;15;19;878016;881104;3088
"3730";32;2;51;20;886999;890073;3074
"3816";32;4;61;21;893259;897065;3806
"3931";32;4;77;22;899955;904695;4740
"4016";32;2;95;23;908182;911286;3104
"4131";32;2;59;24;914728;917445;2717
"4229";32;2;11;25;921154;924412;3258
"4428";32;4;25;26;930440;934310;3870
"4629";32;4;85;27;940582;943952;3370
"4731";32;4;33;28;948179;951185;3006
"4928";32;2;67;29;956942;960398;3456
"5031";32;2;79;30;964719;967392;2673
"5131";32;4;93;31;970437;974463;4026
"5231";32;4;65;32;977150;980276;3126
"5316";32;4;17;33;983610;987500;3890
"5529";32;4;57;34;994067;997433;3366
"5615";32;4;5;35;1000245;1004183;3938
"5813";32;2;3;36;1010699;1014932;4233
"6028";32;2;27;37;1021116;1024490;3374
"6214";32;4;21;38;1029847;1034832;4985
"6414";32;2;75;39;1039917;1044223;4306
"6530";32;4;73;40;1048077;1052081;4004
"6616";32;2;87;41;1055498;1058106;2608
"6731";32;4;45;42;1061403;1066181;4778
"6830";32;2;63;43;1069108;1073922;4814
"6931";32;4;41;44;1076662;1079247;2585
"7016";32;4;29;45;1082519;1088230;5711
"7214";32;4;69;46;1094710;1099963;5253
"7329";32;4;49;47;1103166;1107379;4213
"7416";32;4;89;48;1300561;1303858;3297
"7531";32;2;31;49;1312326;1316000;3674
"7729";32;4;13;50;1322594;1325249;2655
"7929";32;3;64;51;1331081;1336191;5110
"8029";32;3;80;52;1339513;1344219;4706
"8131";32;3;44;53;1348197;1353399;5202
"8230";32;3;68;54;1360633;1365476;4843
"8315";32;1;70;55;1368142;1371292;3150
"8430";32;3;12;56;1374472;1379531;5059
"8615";32;1;6;57;1385357;1387749;2392
"8815";32;3;32;58;1392450;1395518;3068
"9015";32;1;22;59;1402507;1405580;3073
"9230";32;3;60;60;1413096;1417463;4367
"9318";32;1;90;61;1425383;1429696;4313
"9431";32;1;66;62;1433110;1437554;4444
"9531";32;1;14;63;1441345;1445065;3720
"9729";32;3;76;64;1454623;1459011;4388
"9815";32;3;84;65;1466646;1471129;4483
"9930";32;3;56;66;1475956;1478969;3013
"10015";32;1;34;67;1483205;1486535;3330
"10219";32;1;82;68;1495899;1498749;2850
"10327";32;1;94;69;1502588;1505210;2622
"10431";32;3;28;70;1508725;1515029;6304
"10617";32;3;92;71;1521258;1527501;6243
"10727";32;3;16;72;1532567;1537684;5117
"10929";32;1;10;73;1545270;1547933;2663
"11135";32;3;96;74;1556890;1562174;5284
"11230";32;1;58;75;1567958;1570682;2724
"11319";32;1;42;76;1573627;1576849;3222
"11430";32;1;50;77;1580438;1583865;3427
"11517";32;1;74;78;1587032;1589290;2258
"11631";32;1;62;79;1594504;1596923;2419
"11731";32;1;98;80;1599358;1601406;2048
"11816";32;1;54;81;1604164;1606348;2184
"11931";32;3;100;82;1609171;1612497;3326
"12031";32;3;52;83;1616447;1620497;4050
"12135";32;1;86;84;1743233;1745601;2368
"12233";32;1;38;85;1750550;1752984;2434
"12417";32;3;88;86;1757778;1761535;3757
"12528";32;1;30;87;1764762;1767917;3155
"12716";32;1;2;88;1773542;1776800;3258
"12915";32;3;72;89;1782328;1789141;6813
"13028";32;1;46;90;1793749;1796616;2867
"13120";32;3;4;91;1799819;1803124;3305
"13316";32;3;8;92;1808768;1812824;4056
"13529";32;3;36;93;1824694;1829010;4316
"13730";32;3;48;94;1840323;1844035;3712
"13828";32;1;78;95;1847298;1852068;4770
"13931";32;1;26;96;1855610;1857930;2320
"14119";32;1;18;97;1863413;1865750;2337
"14330";32;3;40;98;1875706;1879502;3796
"14530";32;3;20;99;1884696;1889935;5239
"14730";32;3;24;100;1896958;1900920;3962
"9109";33;3;63;1;2352595;2357756;5161
"10125";33;3;79;2;2391721;2396946;5225
"11136";33;3;43;3;2403162;2407899;4737
"12136";33;3;67;4;2415496;2420579;5083
"13100";33;1;69;5;2471575;2475552;3977
"1485";33;3;11;6;2478388;2483476;5088
"1615";33;1;5;7;2489328;2493643;4315
"1816";33;3;31;8;2499695;2504216;4521
"2016";33;1;21;9;2510817;2514209;3392
"2232";33;3;59;10;2520276;2523733;3457
"2316";33;1;89;11;2526247;2528811;2564
"2431";33;1;65;12;2532983;2536540;3557
"2531";33;1;13;13;2540525;2544941;4416
"2732";33;3;75;14;2550210;2555852;5642
"2817";33;3;83;15;2560697;2563683;2986
"2930";33;3;55;16;2566518;2570207;3689
"3017";33;1;33;17;2574379;2577407;3028
"3217";33;1;81;18;2586621;2589823;3202
"3331";33;1;93;19;2593592;2599114;5522
"3431";33;3;27;20;2601894;2604863;2969
"3617";33;3;91;21;2650443;2653670;3227
"3731";33;3;15;22;2656215;2659827;3612
"3932";33;1;9;23;2666648;2670053;3405
"4132";33;3;95;24;2675928;2679403;3475
"4230";33;1;57;25;2682239;2685381;3142
"4318";33;1;41;26;2690583;2694052;3469
"4429";33;1;49;27;2696270;2699069;2799
"4518";33;1;73;28;2701719;2705678;3959
"4630";33;1;61;29;2708041;2710702;2661
"4732";33;1;97;30;2712998;2716443;3445
"4818";33;1;53;31;2718847;2722801;3954
"4929";33;3;99;32;2726009;2729768;3759
"5032";33;3;51;33;2732212;2736680;4468
"5132";33;1;85;34;2739216;2741817;2601
"5232";33;1;37;35;2744962;2748517;3555
"5417";33;3;87;36;2756116;2760192;4076
"5530";33;1;29;37;2762976;2765995;3019
"5718";33;1;1;38;2772585;2776767;4182
"5918";33;3;71;39;2784964;2789482;4518
"6029";33;1;45;40;2792114;2794965;2851
"6118";33;3;3;41;2797383;2800915;3532
"6317";33;3;7;42;2808596;2814277;5681
"6531";33;3;35;43;2821601;2825856;4255
"6732";33;3;47;44;2832279;2835894;3615
"6831";33;1;77;45;2839615;2845006;5391
"6932";33;1;25;46;2849437;2851905;2468
"7118";33;1;17;47;2859443;2862780;3337
"7330";33;3;39;48;2868290;2871463;3173
"7532";33;3;19;49;2880154;2883954;3800
"7730";33;3;23;50;2977374;2980518;3144
"7930";33;2;98;51;2991839;2994175;2336
"8030";33;4;84;52;3028053;3031348;3295
"8132";33;2;82;53;3033868;3036282;2414
"8231";33;2;10;54;3038670;3042840;4170
"8431";33;4;92;55;3048827;3052623;3796
"8519";33;4;36;56;3057210;3061299;4089
"8716";33;2;38;57;3066488;3068714;2226
"8916";33;4;8;58;3073757;3077514;3757
"9123";33;2;54;59;3082871;3084939;2068
"9231";33;4;20;60;3087547;3091489;3942
"9432";33;4;48;61;3096856;3100128;3272
"9532";33;4;56;62;3102504;3106555;4051
"9619";33;4;44;63;3108880;3111481;2601
"9730";33;4;24;64;3113987;3117329;3342
"9931";33;4;40;65;3123557;3126163;2606
"10126";33;2;2;66;3133855;3137187;3332
"10328";33;4;72;67;3143417;3147612;4195
"10432";33;4;100;68;3150203;3153212;3009
"10519";33;4;16;69;3157868;3161420;3552
"10728";33;4;52;70;3169050;3173919;4869
"10820";33;2;62;71;3178251;3180435;2184
"10930";33;2;78;72;3183305;3186511;3206
"11017";33;4;96;73;3189775;3193035;3260
"11137";33;4;60;74;3195746;3200068;4322
"11231";33;4;12;75;3206864;3210301;3437
"11431";33;2;26;76;3215824;3218551;2727
"11632";33;2;86;77;3223864;3226073;2209
"11732";33;2;34;78;3229002;3232409;3407
"11932";33;4;68;79;3237967;3240842;2875
"12032";33;4;80;80;3244341;3248058;3717
"12137";33;2;94;81;3252070;3254915;2845
"12234";33;2;66;82;3257396;3261675;4279
"12322";33;2;18;83;3263924;3268124;4200
"12529";33;2;58;84;3272978;3276804;3826
"12620";33;2;6;85;3279350;3282191;2841
"12817";33;4;4;86;3287933;3292082;4149
"13029";33;4;28;87;3297220;3300798;3578
"13221";33;2;22;88;3306665;3309014;2349
"13417";33;4;76;89;3314963;3320081;5118
"13530";33;2;74;90;3322614;3324931;2317
"13617";33;4;88;91;3328882;3332655;3773
"13731";33;2;46;92;3335238;3338552;3314
"13829";33;4;64;93;3341855;3345305;3450
"13932";33;2;42;94;3350034;3354096;4062
"14019";33;2;30;95;3357680;3360688;3008
"14220";33;2;70;96;3367057;3370346;3289
"14331";33;2;50;97;3373523;3377012;3489
"14417";33;2;90;98;3381308;3384128;2820
"14531";33;4;32;99;3389391;3393204;3813
"14731";33;2;14;100;3399040;3402053;3013
"9124";34;2;97;1;1055234;1058605;3371
"10127";34;4;83;2;1061620;1065480;3860
"11138";34;2;81;3;1069604;1072013;2409
"12138";34;2;9;4;1076293;1079305;3012
"1486";34;4;91;5;1088968;1092629;3661
"1517";34;4;35;6;1095439;1098979;3540
"1717";34;2;37;7;1106247;1108529;2282
"1916";34;4;7;8;1114549;1117662;3113
"2117";34;2;53;9;1124356;1126970;2614
"2233";34;4;19;10;1130017;1133361;3344
"2432";34;4;47;11;1141287;1144636;3349
"2532";34;4;55;12;1148521;1152343;3822
"2617";34;4;43;13;1154886;1159152;4266
"2733";34;4;23;14;1162676;1166935;4259
"2931";34;4;39;15;1173033;1177176;4143
"3116";34;2;1;16;1183336;1187484;4148
"3332";34;4;71;17;1193588;1198409;4821
"3432";34;4;99;18;1201365;1205750;4385
"3517";34;4;15;19;1209691;1212475;2784
"3732";34;4;51;20;1218436;1221708;3272
"3817";34;2;61;21;1224009;1226758;2749
"3933";34;2;77;22;1229909;1232491;2582
"4017";34;4;95;23;1235301;1238207;2906
"4133";34;4;59;24;1240862;1243341;2479
"4231";34;4;11;25;1245807;1248882;3075
"4430";34;2;25;26;1255761;1258732;2971
"4631";34;2;85;27;1263878;1266981;3103
"4733";34;2;33;28;1269419;1272615;3196
"4930";34;4;67;29;1278892;1282056;3164
"5033";34;4;79;30;1326932;1331739;4807
"5133";34;2;93;31;1334056;1337681;3625
"5233";34;2;65;32;1339934;1343756;3822
"5317";34;2;17;33;1346783;1350239;3456
"5531";34;2;57;34;1356656;1359272;2616
"5616";34;2;5;35;1362567;1366554;3987
"5814";34;4;3;36;1373114;1377313;4199
"6030";34;4;27;37;1383005;1385946;2941
"6215";34;2;21;38;1391113;1393445;2332
"6415";34;4;75;39;1401331;1405995;4664
"6532";34;2;73;40;1408749;1410995;2246
"6617";34;4;87;41;1414415;1417145;2730
"6733";34;2;45;42;1419515;1421453;1938
"6832";34;4;63;43;1423714;1426519;2805
"6933";34;2;41;44;1428791;1431469;2678
"7017";34;2;29;45;1434029;1437102;3073
"7215";34;2;69;46;1441754;1445177;3423
"7331";34;2;49;47;1447377;1450168;2791
"7417";34;2;89;48;1455647;1457885;2238
"7533";34;4;31;49;1460627;1464626;3999
"7731";34;2;13;50;1469582;1471751;2169
"7931";34;1;64;51;1476603;1480109;3506
"8031";34;1;80;52;1482705;1486125;3420
"8133";34;1;44;53;1489033;1491850;2817
"8232";34;1;68;54;1494052;1497408;3356
"8316";34;3;70;55;1500173;1503783;3610
"8432";34;1;12;56;1507808;1511083;3275
"8616";34;3;6;57;1516514;1522091;5577
"8816";34;1;32;58;1527162;1530674;3512
"9016";34;3;22;59;1535521;1539198;3677
"9232";34;1;60;60;1544263;1547007;2744
"9319";34;3;90;61;1549315;1552923;3608
"9433";34;3;66;62;1555213;1559573;4360
"9533";34;3;14;63;1561692;1565339;3647
"9731";34;1;76;64;1572422;1575672;3250
"9816";34;1;84;65;1578466;1582514;4048
"9932";34;1;56;66;1586277;1587989;1712
"10016";34;3;34;67;1590367;1593597;3230
"10220";34;3;82;68;1627026;1630570;3544
"10329";34;3;94;69;1633420;1636362;2942
"10433";34;1;28;70;1639333;1643695;4362
"10618";34;1;92;71;1651673;1654919;3246
"10729";34;1;16;72;1657784;1661127;3343
"10931";34;3;10;73;1666750;1670210;3460
"11139";34;1;96;74;1677973;1681660;3687
"11232";34;3;58;75;1684170;1688027;3857
"11320";34;3;42;76;1691836;1695493;3657
"11432";34;3;50;77;1697733;1702826;5093
"11518";34;3;74;78;1706106;1710734;4628
"11633";34;3;62;79;1713262;1717509;4247
"11733";34;3;98;80;1719751;1723017;3266
"11817";34;3;54;81;1725494;1730258;4764
"11933";34;1;100;82;1732670;1736074;3404
"12033";34;1;52;83;1739587;1742483;2896
"12139";34;3;86;84;1746989;1750982;3993
"12235";34;3;38;85;1753370;1757441;4071
"12418";34;1;88;86;1763194;1767807;4613
"12530";34;3;30;87;1770110;1774257;4147
"12717";34;3;2;88;1780276;1784498;4222
"12916";34;1;72;89;1790799;1795164;4365
"13030";34;3;46;90;1797425;1800981;3556
"13121";34;1;4;91;1804214;1806589;2375
"13317";34;1;8;92;1813427;1816630;3203
"13531";34;1;36;93;1823482;1826797;3315
"13732";34;1;48;94;1832852;1835896;3044
"13830";34;3;78;95;1839483;1844454;4971
"13933";34;3;26;96;1846704;1850979;4275
"14120";34;3;18;97;1857485;1861179;3694
"14332";34;1;40;98;1866032;1868203;2171
"14532";34;1;20;99;1874316;1877228;2912
"14732";34;1;24;100;1882094;1885886;3792
"9125";35;1;63;1;3524156;3529102;4946
"10128";35;1;79;2;3532378;3539543;7165
"11140";35;1;43;3;3541777;3547685;5908
"12140";35;1;67;4;3550524;3555809;5285
"13101";35;3;69;5;3558704;3565084;6380
"1487";35;1;11;6;3568257;3572917;4660
"1616";35;3;5;7;3579429;3586142;6713
"1817";35;1;31;8;3592876;3599141;6265
"2017";35;3;21;9;3605099;3610607;5508
"2234";35;1;59;10;3617414;3621207;3793
"2317";35;3;89;11;3624237;3628957;4720
"2433";35;3;65;12;3631809;3636765;4956
"2533";35;3;13;13;3639504;3645048;5544
"2734";35;1;75;14;3651048;3657798;6750
"2818";35;1;83;15;3661069;3665139;4070
"2932";35;1;55;16;3721035;3725895;4860
"3018";35;3;33;17;3728737;3735070;6333
"3218";35;3;81;18;3740199;3748302;8103
"3333";35;3;93;19;3751682;3759835;8153
"3433";35;1;27;20;3763556;3770085;6529
"3618";35;1;91;21;3775435;3779826;4391
"3733";35;1;15;22;3782622;3787076;4454
"3934";35;3;9;23;3792350;3798217;5867
"4134";35;1;95;24;3802994;3807575;4581
"4232";35;3;57;25;3844566;3850651;6085
"4319";35;3;41;26;3853204;3858092;4888
"4431";35;3;49;27;3860430;3867217;6787
"4519";35;3;73;28;3869704;3875433;5729
"4632";35;3;61;29;3877593;3883716;6123
"4734";35;3;97;30;3886062;3894316;8254
"4819";35;3;53;31;3896981;3902132;5151
"4931";35;1;99;32;3904596;3909873;5277
"5034";35;1;51;33;3912605;3917048;4443
"5134";35;3;85;34;3919765;3927898;8133
"5234";35;3;37;35;3930391;3937022;6631
"5418";35;1;87;36;3942506;3945539;3033
"5532";35;3;29;37;3948366;3955930;7564
"5719";35;3;1;38;3961484;3967471;5987
"5919";35;1;71;39;3972757;3977238;4481
"6031";35;3;45;40;3979617;3984546;4929
"6119";35;1;3;41;3986776;3991737;4961
"6318";35;1;7;42;3996954;4000545;3591
"6533";35;1;35;43;4006554;4009770;3216
"6734";35;1;47;44;4014865;4023319;8454
"6833";35;3;77;45;4025528;4030061;4533
"6934";35;3;25;46;4032359;4039344;6985
"7119";35;3;17;47;4044238;4050185;5947
"7332";35;1;39;48;4055540;4059668;4128
"7534";35;1;19;49;4065691;4070543;4852
"7732";35;1;23;50;4114885;4118149;3264
"7932";35;4;98;51;4126338;4131024;4686
"8032";35;2;84;52;4134363;4138665;4302
"8134";35;4;82;53;4142610;4147790;5180
"8233";35;4;10;54;4152115;4154898;2783
"8433";35;2;92;55;4166496;4170889;4393
"8520";35;2;36;56;4202490;4205229;2739
"8717";35;4;38;57;4210266;4214146;3880
"8917";35;2;8;58;4225613;4230029;4416
"9126";35;4;54;59;4234778;4238870;4092
"9233";35;2;20;60;4241403;4244053;2650
"9434";35;2;48;61;4249278;4252570;3292
"9534";35;2;56;62;4255194;4258161;2967
"9620";35;2;44;63;4261024;4265561;4537
"9732";35;2;24;64;4268068;4271010;2942
"9933";35;2;40;65;4275898;4278294;2396
"10129";35;4;2;66;4283170;4286585;3415
"10330";35;2;72;67;4291628;4296001;4373
"10434";35;2;100;68;4299191;4301859;2668
"10520";35;2;16;69;4304134;4307768;3634
"10730";35;2;52;70;4313545;4317317;3772
"10821";35;4;62;71;4319553;4324117;4564
"10932";35;4;78;72;4329185;4334825;5640
"11018";35;2;96;73;4337471;4339766;2295
"11141";35;2;60;74;4368932;4370865;1933
"11233";35;2;12;75;4373430;4375823;2393
"11433";35;4;26;76;4380867;4383631;2764
"11634";35;4;86;77;4388592;4392314;3722
"11734";35;4;34;78;4394623;4398014;3391
"11934";35;2;68;79;4403477;4406514;3037
"12034";35;2;80;80;4409033;4412005;2972
"12141";35;4;94;81;4414341;4418263;3922
"12236";35;4;66;82;4420757;4426063;5306
"12323";35;4;18;83;4428658;4431313;2655
"12531";35;4;58;84;4437356;4441429;4073
"12621";35;4;6;85;4443676;4448204;4528
"12818";35;2;4;86;4452756;4455145;2389
"13031";35;2;28;87;4462865;4466245;3380
"13222";35;4;22;88;4472217;4475737;3520
"13418";35;2;76;89;4481202;4483486;2284
"13532";35;4;74;90;4486394;4490011;3617
"13618";35;2;88;91;4493056;4497169;4113
"13733";35;4;46;92;4499479;4504302;4823
"13831";35;2;64;93;4506967;4509760;2793
"13934";35;4;42;94;4512790;4515785;2995
"14020";35;4;30;95;4518474;4521634;3160
"14221";35;4;70;96;4526778;4531743;4965
"14333";35;4;50;97;4534053;4539626;5573
"14418";35;4;90;98;4541840;4546076;4236
"14533";35;2;32;99;4548473;4551909;3436
"14733";35;4;14;100;4556562;4560059;3497
"9127";36;4;97;1;2392486;2397053;4567
"10130";36;2;83;2;2400611;2404078;3467
"11142";36;4;81;3;2408432;2411911;3479
"12142";36;4;9;4;2417930;2421407;3477
"1488";36;2;91;5;2428480;2431832;3352
"1518";36;2;35;6;2434927;2438002;3075
"1718";36;4;37;7;2444424;2448681;4257
"1917";36;2;7;8;2454523;2457617;3094
"2118";36;4;53;9;2466126;2469899;3773
"2235";36;2;19;10;2472751;2475978;3227
"2434";36;2;47;11;2481595;2484292;2697
"2534";36;2;55;12;2486584;2489600;3016
"2618";36;2;43;13;2494099;2497949;3850
"2735";36;2;23;14;2501526;2504413;2887
"2933";36;2;39;15;2509301;2512565;3264
"3117";36;4;1;16;2518600;2523199;4599
"3334";36;2;71;17;2530243;2534246;4003
"3434";36;2;99;18;2537988;2541948;3960
"3518";36;2;15;19;2544560;2548356;3796
"3734";36;2;51;20;2555917;2559856;3939
"3818";36;4;61;21;2562542;2566832;4290
"3935";36;4;77;22;2569671;2573680;4009
"4018";36;2;95;23;2577965;2580863;2898
"4135";36;2;59;24;2585538;2588258;2720
"4233";36;2;11;25;2591726;2594638;2912
"4432";36;4;25;26;2602070;2607279;5209
"4633";36;4;85;27;2613004;2618278;5274
"4735";36;4;33;28;2622925;2626387;3462
"4932";36;2;67;29;2632755;2636153;3398
"5035";36;2;79;30;2639924;2643478;3554
"5135";36;4;93;31;2648833;2652952;4119
"5235";36;4;65;32;2655332;2660086;4754
"5318";36;4;17;33;2666082;2670702;4620
"5533";36;4;57;34;2675462;2680632;5170
"5617";36;4;5;35;2684804;2688873;4069
"5815";36;2;3;36;2695790;2699101;3311
"6032";36;2;27;37;2705286;2708442;3156
"6216";36;4;21;38;2714082;2717942;3860
"6416";36;2;75;39;2723938;2728041;4103
"6534";36;4;73;40;2732833;2736533;3700
"6618";36;2;87;41;2739201;2742607;3406
"6735";36;4;45;42;2746363;2750491;4128
"6834";36;2;63;43;2754156;2757293;3137
"6935";36;4;41;44;2762153;2766074;3921
"7018";36;4;29;45;2772657;2778914;6257
"7216";36;4;69;46;2788934;2797790;8856
"7333";36;4;49;47;2801340;2805489;4149
"7418";36;4;89;48;3164817;3168404;3587
"7535";36;2;31;49;3171259;3175020;3761
"7733";36;4;13;50;3185289;3188720;3431
"7933";36;3;64;51;3196290;3201933;5643
"8033";36;3;80;52;3204611;3209836;5225
"8135";36;3;44;53;3213272;3217761;4489
"8234";36;3;68;54;3222349;3227952;5603
"8317";36;1;70;55;3231830;3235096;3266
"8434";36;3;12;56;3242410;3248096;5686
"8617";36;1;6;57;3255115;3259109;3994
"8817";36;3;32;58;3266235;3270642;4407
"9017";36;1;22;59;3596977;3600659;3682
"9234";36;3;60;60;3606330;3610474;4144
"9320";36;1;90;61;3614985;3618307;3322
"9435";36;1;66;62;3620608;3624315;3707
"9535";36;1;14;63;3626549;3630506;3957
"9733";36;3;76;64;3635801;3640664;4863
"9817";36;3;84;65;3642834;3648464;5630
"9934";36;3;56;66;3652616;3656797;4181
"10017";36;1;34;67;3659228;3662598;3370
"10221";36;1;82;68;3669090;3672172;3082
"10331";36;1;94;69;3675109;3679903;4794
"10435";36;3;28;70;3682335;3688363;6028
"10619";36;3;92;71;3696283;3702804;6521
"10731";36;3;16;72;3707914;3713204;5290
"10933";36;1;10;73;3719838;3725946;6108
"11143";36;3;96;74;3734527;3739212;4685
"11234";36;1;58;75;3741873;3747969;6096
"11321";36;1;42;76;3753255;3757836;4581
"11434";36;1;50;77;3760327;3765502;5175
"11519";36;1;74;78;3768311;3771276;2965
"11635";36;1;62;79;3773729;3776443;2714
"11735";36;1;98;80;3779732;3782151;2419
"11818";36;1;54;81;3784642;3788818;4176
"11935";36;3;100;82;3791570;3795655;4085
"12035";36;3;52;83;3798579;3803309;4730
"12143";36;1;86;84;3805902;3809417;3515
"12237";36;1;38;85;3812987;3816283;3296
"12419";36;3;88;86;3821645;3826800;5155
"12532";36;1;30;87;3829554;3832383;2829
"12718";36;1;2;88;3839036;3842124;3088
"12917";36;3;72;89;3848026;3853132;5106
"13032";36;1;46;90;3855585;3859249;3664
"13122";36;3;4;91;3861733;3865832;4099
"13318";36;3;8;92;3872030;3876681;4651
"13533";36;3;36;93;3884189;3888246;4057
"13734";36;3;48;94;3893860;3899430;5570
"13832";36;1;78;95;3905976;3909380;3404
"13935";36;1;26;96;3913014;3917171;4157
"14121";36;1;18;97;3925396;3930288;4892
"14334";36;3;40;98;3939009;3942845;3836
"14534";36;3;20;99;3949294;3954903;5609
"14734";36;3;24;100;3961408;3966453;5045
"9128";37;3;63;1;4290901;4295763;4862
"10131";37;3;79;2;4299691;4305252;5561
"11144";37;3;43;3;4307855;4313801;5946
"12144";37;3;67;4;4317850;4323268;5418
"13102";37;1;69;5;4329210;4335700;6490
"1489";37;3;11;6;4340615;4346200;5585
"1617";37;1;5;7;4353381;4357183;3802
"1818";37;3;31;8;4363139;4369199;6060
"2018";37;1;21;9;4374670;4378991;4321
"2236";37;3;59;10;4384617;4391291;6674
"2318";37;1;89;11;4393600;4397474;3874
"2435";37;1;65;12;4399739;4403373;3634
"2535";37;1;13;13;4405767;4409948;4181
"2736";37;3;75;14;4415596;4421964;6368
"2819";37;3;83;15;4424387;4428739;4352
"2934";37;3;55;16;4431135;4436897;5762
"3019";37;1;33;17;4439878;4443388;3510
"3219";37;1;81;18;4448864;4453165;4301
"3335";37;1;93;19;4455442;4460529;5087
"3435";37;3;27;20;4462877;4467579;4702
"3619";37;3;91;21;4474520;4480770;6250
"3735";37;3;15;22;4486431;4491312;4881
"3936";37;1;9;23;4497776;4502160;4384
"4136";37;3;95;24;4507505;4512617;5112
"4234";37;1;57;25;4514888;4519025;4137
"4320";37;1;41;26;4521552;4525834;4282
"4433";37;1;49;27;4528089;4532643;4554
"4520";37;1;73;28;4534917;4538960;4043
"4634";37;1;61;29;4541228;4544760;3532
"4736";37;1;97;30;4547119;4551820;4701
"4820";37;1;53;31;4554171;4557948;3777
"4933";37;3;99;32;4562281;4566543;4262
"5036";37;3;51;33;4568914;4573622;4708
"5136";37;1;85;34;4578156;4582109;3953
"5236";37;1;37;35;4590226;4594302;4076
"5419";37;3;87;36;4604510;4610608;6098
"5534";37;1;29;37;4612968;4618216;5248
"5720";37;1;1;38;4623336;4628415;5079
"5920";37;3;71;39;4634313;4638807;4494
"6033";37;1;45;40;4641212;4644114;2902
"6120";37;3;3;41;4646481;4650923;4442
"6319";37;3;7;42;4656888;4661548;4660
"6535";37;3;35;43;4667303;4672264;4961
"6736";37;3;47;44;4677957;4682922;4965
"6835";37;1;77;45;4686088;4690430;4342
"6936";37;1;25;46;4692983;4697238;4255
"7120";37;1;17;47;4702354;4706110;3756
"7334";37;3;39;48;4810189;4818077;7888
"7536";37;3;19;49;4823642;4828233;4591
"7734";37;3;23;50;4833785;4838300;4515
"7934";37;2;98;51;4846052;4850135;4083
"8034";37;4;84;52;4854968;4859365;4397
"8136";37;2;82;53;4863256;4866407;3151
"8235";37;2;10;54;4868868;4871873;3005
"8435";37;4;92;55;4879253;4884058;4805
"8521";37;4;36;56;4886507;4890394;3887
"8718";37;2;38;57;4896109;4898881;2772
"8918";37;4;8;58;4906712;4911355;4643
"9129";37;2;54;59;4916532;4919213;2681
"9235";37;4;20;60;4924327;4929638;5311
"9436";37;4;48;61;4935217;4939313;4096
"9536";37;4;56;62;4942656;4946146;3490
"9621";37;4;44;63;4948629;4953371;4742
"9734";37;4;24;64;4962092;4966653;4561
"9935";37;4;40;65;4973191;4976511;3320
"10132";37;2;2;66;4985147;4988886;3739
"10332";37;4;72;67;4994471;4999261;4790
"10436";37;4;100;68;5001778;5005226;3448
"10521";37;4;16;69;5012895;5017127;4232
"10732";37;4;52;70;5053209;5059467;6258
"10822";37;2;62;71;5061996;5065142;3146
"10934";37;2;78;72;5069367;5073791;4424
"11019";37;4;96;73;5077531;5081516;3985
"11145";37;4;60;74;5085784;5089666;3882
"11235";37;4;12;75;5095304;5099449;4145
"11435";37;2;26;76;5105046;5108712;3666
"11636";37;2;86;77;5116618;5119532;2914
"11736";37;2;34;78;5123588;5126806;3218
"11936";37;4;68;79;5133835;5138989;5154
"12036";37;4;80;80;5141300;5145979;4679
"12145";37;2;94;81;5150098;5153340;3242
"12238";37;2;66;82;5158571;5164980;6409
"12324";37;2;18;83;5167386;5171030;3644
"12533";37;2;58;84;5176684;5180871;4187
"12622";37;2;6;85;5183245;5185979;2734
"12819";37;4;4;86;5192754;5196526;3772
"13033";37;4;28;87;5201613;5207271;5658
"13223";37;2;22;88;5213561;5216028;2467
"13419";37;4;76;89;5224105;5228519;4414
"13534";37;2;74;90;5234013;5237161;3148
"13619";37;4;88;91;5242354;5246754;4400
"13735";37;2;46;92;5252344;5255110;2766
"13833";37;4;64;93;5257630;5262585;4955
"13936";37;2;42;94;5266226;5268826;2600
"14021";37;2;30;95;5274311;5277592;3281
"14222";37;2;70;96;5283186;5286534;3348
"14335";37;2;50;97;5288819;5292334;3515
"14419";37;2;90;98;5294747;5297675;2928
"14535";37;4;32;99;5300085;5304275;4190
"14735";37;2;14;100;5310879;5313875;2996
"9130";38;2;97;1;5657419;5661031;3612
"10133";38;4;83;2;5663182;5666923;3741
"11146";38;2;81;3;5669278;5672322;3044
"12146";38;2;9;4;5675103;5678347;3244
"1490";38;4;91;5;5683513;5687055;3542
"1519";38;4;35;6;5689228;5693230;4002
"1719";38;2;37;7;5698458;5702221;3763
"1918";38;4;7;8;5707764;5711379;3615
"2119";38;2;53;9;5717807;5723162;5355
"2237";38;4;19;10;5725762;5730278;4516
"2436";38;4;47;11;5737756;5741370;3614
"2536";38;4;55;12;5744952;5750328;5376
"2619";38;4;43;13;5753540;5758128;4588
"2737";38;4;23;14;5760314;5765353;5039
"2935";38;4;39;15;5770533;5774118;3585
"3118";38;2;1;16;5781134;5785418;4284
"3336";38;4;71;17;5796129;5801376;5247
"3436";38;4;99;18;5803624;5810568;6944
"3519";38;4;15;19;5812604;5817867;5263
"3736";38;4;51;20;5823399;5828967;5568
"3819";38;2;61;21;5831599;5835975;4376
"3937";38;2;77;22;5837944;5842125;4181
"4019";38;4;95;23;5844354;5849883;5529
"4137";38;4;59;24;5852066;5855916;3850
"4235";38;4;11;25;5858079;5862607;4528
"4434";38;2;25;26;5868576;5872899;4323
"4635";38;2;85;27;5877887;5882257;4370
"4737";38;2;33;28;5884293;5887440;3147
"4934";38;4;67;29;5892394;5896890;4496
"5037";38;4;79;30;5899107;5903681;4574
"5137";38;2;93;31;5906378;5910589;4211
"5237";38;2;65;32;5912849;5917022;4173
"5319";38;2;17;33;5920352;5924980;4628
"5535";38;2;57;34;5931280;5934296;3016
"5618";38;2;5;35;5936679;5939530;2851
"5816";38;4;3;36;5945632;5949221;3589
"6034";38;4;27;37;5960814;5964796;3982
"6217";38;2;21;38;5969616;5973079;3463
"6417";38;4;75;39;5981336;5986778;5442
"6536";38;2;73;40;5990428;5995928;5500
"6619";38;4;87;41;5998999;6004877;5878
"6737";38;2;45;42;6009297;6013369;4072
"6836";38;4;63;43;6015689;6021918;6229
"6937";38;2;41;44;6024109;6028743;4634
"7019";38;2;29;45;6031150;6037168;6018
"7217";38;2;69;46;6042521;6048476;5955
"7335";38;2;49;47;6050746;6055509;4763
"7419";38;2;89;48;6058230;6062575;4345
"7537";38;4;31;49;6200826;6206123;5297
"7735";38;2;13;50;6212114;6215556;3442
"7935";38;1;64;51;6221167;6225039;3872
"8035";38;1;80;52;6229425;6235064;5639
"8137";38;1;44;53;6238088;6242081;3993
"8236";38;1;68;54;6244550;6249330;4780
"8318";38;3;70;55;6252030;6256946;4916
"8436";38;1;12;56;6259286;6264737;5451
"8618";38;3;6;57;6270671;6276154;5483
"8818";38;1;32;58;6282238;6285020;2782
"9018";38;3;22;59;6291350;6296762;5412
"9236";38;1;60;60;6302149;6305653;3504
"9321";38;3;90;61;6310899;6316853;5954
"9437";38;3;66;62;6322019;6328144;6125
"9537";38;3;14;63;6332175;6337652;5477
"9735";38;1;76;64;6343521;6347243;3722
"9818";38;1;84;65;6350380;6355968;5588
"9936";38;1;56;66;6359259;6364043;4784
"10018";38;3;34;67;6367695;6373542;5847
"10222";38;3;82;68;6379724;6384425;4701
"10333";38;3;94;69;6390782;6395233;4451
"10437";38;1;28;70;6398304;6404100;5796
"10620";38;1;92;71;6412663;6416724;4061
"10733";38;1;16;72;6453280;6456981;3701
"10935";38;3;10;73;6462506;6467514;5008
"11147";38;1;96;74;6474891;6478855;3964
"11236";38;3;58;75;6482234;6487172;4938
"11322";38;3;42;76;6490413;6494663;4250
"11436";38;3;50;77;6497765;6503488;5723
"11520";38;3;74;78;6506780;6511412;4632
"11637";38;3;62;79;6514494;6518979;4485
"11737";38;3;98;80;6522601;6527554;4953
"11819";38;3;54;81;6529842;6534220;4378
"11937";38;1;100;82;6536595;6540261;3666
"12037";38;1;52;83;6542828;6546170;3342
"12147";38;3;86;84;6548491;6552661;4170
"12239";38;3;38;85;6556044;6559753;3709
"12420";38;1;88;86;6566474;6570511;4037
"12534";38;3;30;87;6573667;6577919;4252
"12719";38;3;2;88;6582753;6589119;6366
"12918";38;1;72;89;6594720;6598543;3823
"13034";38;3;46;90;6600876;6605959;5083
"13123";38;1;4;91;6608154;6611501;3347
"13319";38;1;8;92;6617953;6621634;3681
"13535";38;1;36;93;6627712;6632800;5088
"13736";38;1;48;94;6637671;6642250;4579
"13834";38;3;78;95;6644556;6647999;3443
"13937";38;3;26;96;6650306;6653583;3277
"14122";38;3;18;97;6658519;6661932;3413
"14336";38;1;40;98;6666933;6669548;2615
"14536";38;1;20;99;6674308;6677240;2932
"14736";38;1;24;100;6682210;6685732;3522
"9131";39;1;63;1;7661709;7666150;4441
"10134";39;1;79;2;7668518;7673147;4629
"11148";39;1;43;3;7676459;7682779;6320
"12148";39;1;67;4;7687813;7694049;6236
"13103";39;3;69;5;7701250;7713092;11842
"1494";39;1;11;6;7720561;7725514;4953
"1618";39;3;5;7;7732820;7739665;6845
"1819";39;1;31;8;7748004;7754847;6843
"2019";39;3;21;9;7760665;7768001;7336
"2238";39;1;59;10;7778789;7784929;6140
"2319";39;3;89;11;7788306;7799555;11249
"2437";39;3;65;12;7803338;7808845;5507
"2537";39;3;13;13;7812650;7817853;5203
"2738";39;1;75;14;7827142;7832686;5544
"2820";39;1;83;15;7837400;7840861;3461
"2936";39;1;55;16;7845171;7850174;5003
"3020";39;3;33;17;7852791;7857302;4511
"3220";39;3;81;18;7863907;7869068;5161
"3337";39;3;93;19;7872563;7879309;6746
"3437";39;1;27;20;7881974;7885617;3643
"3620";39;1;91;21;7891125;7896076;4951
"3737";39;1;15;22;7900863;7905642;4779
"3938";39;3;9;23;7913191;7917666;4475
"4138";39;1;95;24;7924082;7930933;6851
"4236";39;3;57;25;7934480;7940091;5611
"4321";39;3;41;26;7944055;7950869;6814
"4435";39;3;49;27;7954046;7966323;12277
"4521";39;3;73;28;7970884;7977872;6988
"4636";39;3;61;29;7983584;7990208;6624
"4738";39;3;97;30;7996926;8002689;5763
"4821";39;3;53;31;8005365;8010289;4924
"4935";39;1;99;32;8013466;8017753;4287
"5038";39;1;51;33;8020576;8024459;3883
"5138";39;3;85;34;8027314;8033058;5744
"5238";39;3;37;35;8038581;8045298;6717
"5420";39;1;87;36;8050651;8054920;4269
"5536";39;3;29;37;8060882;8066261;5379
"5721";39;3;1;38;8076496;8083252;6756
"5921";39;1;71;39;8090674;8094367;3693
"6035";39;3;45;40;8096621;8100777;4156
"6121";39;1;3;41;8104308;8111910;7602
"6320";39;1;7;42;8119742;8123276;3534
"6537";39;1;35;43;8132940;8137250;4310
"6738";39;1;47;44;8143508;8149950;6442
"6837";39;3;77;45;8157040;8162083;5043
"6938";39;3;25;46;8167149;8174716;7567
"7121";39;3;17;47;8180691;8185933;5242
"7336";39;1;39;48;8193182;8196415;3233
"7538";39;1;19;49;8201561;8205464;3903
"7736";39;1;23;50;8288288;8292988;4700
"7936";39;4;98;51;8298115;8303028;4913
"8036";39;2;84;52;8308366;8314861;6495
"8138";39;4;82;53;8318048;8323094;5046
"8237";39;4;10;54;8326226;8333269;7043
"8437";39;2;92;55;8342132;8346423;4291
"8522";39;2;36;56;8349196;8353334;4138
"8719";39;4;38;57;8361941;8366126;4185
"8919";39;2;8;58;8371923;8376042;4119
"9132";39;4;54;59;8385964;8390417;4453
"9237";39;2;20;60;8396550;8401425;4875
"9438";39;2;48;61;8408838;8414898;6060
"9538";39;2;56;62;8418265;8422890;4625
"9622";39;2;44;63;8427031;8431607;4576
"9736";39;2;24;64;8434460;8439973;5513
"9937";39;2;40;65;8445734;8449273;3539
"10135";39;4;2;66;8454321;8460007;5686
"10334";39;2;72;67;8467749;8472824;5075
"10438";39;2;100;68;8478149;8481797;3648
"10522";39;2;16;69;8485275;8490322;5047
"10734";39;2;52;70;8497746;8503146;5400
"10823";39;4;62;71;8506622;8512229;5607
"10936";39;4;78;72;8519182;8526403;7221
"11020";39;2;96;73;8533884;8539420;5536
"11149";39;2;60;74;8541987;8546536;4549
"11237";39;2;12;75;8550304;8554969;4665
"11437";39;4;26;76;8560521;8564752;4231
"11638";39;4;86;77;8574290;8580887;6597
"11738";39;4;34;78;8583274;8598476;15202
"11938";39;2;68;79;8605747;8610484;4737
"12038";39;2;80;80;8613795;8620258;6463
"12149";39;4;94;81;8622868;8628191;5323
"12240";39;4;66;82;8632179;8640750;8571
"12325";39;4;18;83;8644703;8652224;7521
"12535";39;4;58;84;8660357;8667837;7480
"12623";39;4;6;85;8670582;8675382;4800
"12820";39;2;4;86;8684131;8688318;4187
"13035";39;2;28;87;8694355;8699862;5507
"13224";39;4;22;88;8706414;8710615;4201
"13420";39;2;76;89;8716416;8720416;4000
"13536";39;4;74;90;8724158;8732041;7883
"13620";39;2;88;91;8735662;8740279;4617
"13737";39;4;46;92;8743857;8748914;5057
"13835";39;2;64;93;8752930;8758945;6015
"13938";39;4;42;94;8761806;8770103;8297
"14022";39;4;30;95;8774978;8782669;7691
"14223";39;4;70;96;8788282;8797769;9487
"14337";39;4;50;97;8802004;8809006;7002
"14420";39;4;90;98;8811581;8816727;5146
"14537";39;2;32;99;8819521;8824051;4530
"14737";39;4;14;100;8832316;8837717;5401
"9133";40;4;97;1;9618358;9621775;3417
"10136";40;2;83;2;9624040;9626184;2144
"11150";40;4;81;3;9628395;9631816;3421
"12150";40;4;9;4;9635946;9639058;3112
"1495";40;2;91;5;9645065;9647966;2901
"1520";40;2;35;6;9650100;9653924;3824
"1720";40;4;37;7;9659815;9664441;4626
"1919";40;2;7;8;9670884;9674590;3706
"2120";40;4;53;9;9680302;9684765;4463
"2239";40;2;19;10;9691725;9695756;4031
"2438";40;2;47;11;9702707;9705522;2815
"2538";40;2;55;12;9709271;9712872;3601
"2620";40;2;43;13;9717494;9720122;2628
"2739";40;2;23;14;9722835;9725830;2995
"2937";40;2;39;15;9732218;9734697;2479
"3119";40;4;1;16;9740978;9745004;4026
"3338";40;2;71;17;9750727;9752979;2252
"3438";40;2;99;18;9756487;9759487;3000
"3520";40;2;15;19;9761860;9764512;2652
"3738";40;2;51;20;9770421;9773487;3066
"3820";40;4;61;21;9778653;9781978;3325
"3939";40;4;77;22;9784117;9788253;4136
"4020";40;2;95;23;9790506;9794152;3646
"4139";40;2;59;24;9796474;9798711;2237
"4237";40;2;11;25;9800940;9804727;3787
"4436";40;4;25;26;9809888;9814652;4764
"4637";40;4;85;27;9820428;9826552;6124
"4739";40;4;33;28;9828740;9832143;3403
"4936";40;2;67;29;9841586;9846018;4432
"5039";40;2;79;30;9848354;9851176;2822
"5139";40;4;93;31;9855753;9861908;6155
"5239";40;4;65;32;9865942;9871867;5925
"5320";40;4;17;33;9874323;9877108;2785
"5537";40;4;57;34;9883703;9887091;3388
"5619";40;4;5;35;9889551;9893616;4065
"5817";40;2;3;36;9899004;9903615;4611
"6036";40;2;27;37;9910912;9914123;3211
"6218";40;4;21;38;9919186;9926056;6870
"6418";40;2;75;39;9933915;9939756;5841
"6538";40;4;73;40;9946912;9951472;4560
"6620";40;2;87;41;9955289;9957780;2491
"6739";40;4;45;42;9963343;9966596;3253
"6838";40;2;63;43;9971294;9974905;3611
"6939";40;4;41;44;9978651;9982179;3528
"7020";40;4;29;45;9984494;9988787;4293
"7218";40;4;69;46;9993571;9998370;4799
"7337";40;4;49;47;10002510;10008145;5635
"7420";40;4;89;48;10062418;10064676;2258
"7539";40;2;31;49;10069754;10073159;3405
"7737";40;4;13;50;10079492;10083134;3642
"7937";40;3;64;51;10087782;10092417;4635
"8037";40;3;80;52;10099850;10104508;4658
"8139";40;3;44;53;10108723;10113891;5168
"8238";40;3;68;54;10122712;10129341;6629
"8319";40;1;70;55;10164810;10169023;4213
"8438";40;3;12;56;10171390;10174714;3324
"8619";40;1;6;57;10179637;10183989;4352
"8819";40;3;32;58;10193316;10197847;4531
"9019";40;1;22;59;10208123;10212963;4840
"9238";40;3;60;60;10220655;10225346;4691
"9322";40;1;90;61;10230240;10233353;3113
"9439";40;1;66;62;10235996;10240453;4457
"9539";40;1;14;63;10243384;10246528;3144
"9737";40;3;76;64;10252000;10256361;4361
"9819";40;3;84;65;10259043;10264053;5010
"9938";40;3;56;66;10300436;10303585;3149
"10019";40;1;34;67;10308818;10312468;3650
"10223";40;1;82;68;10318925;10323201;4276
"10335";40;1;94;69;10325616;10328692;3076
"10439";40;3;28;70;10332185;10336809;4624
"10621";40;3;92;71;10343500;10348683;5183
"10735";40;3;16;72;10352869;10358008;5139
"10937";40;1;10;73;10365686;10368907;3221
"11151";40;3;96;74;10377399;10381932;4533
"11238";40;1;58;75;10389799;10393706;3907
"11323";40;1;42;76;10396397;10400081;3684
"11438";40;1;50;77;10402836;10406456;3620
"11521";40;1;74;78;10408975;10413339;4364
"11639";40;1;62;79;10416997;10419881;2884
"11739";40;1;98;80;10425023;10428572;3549
"11820";40;1;54;81;10431541;10434455;2914
"11939";40;3;100;82;10437268;10441755;4487
"12039";40;3;52;83;10444380;10449005;4625
"12151";40;1;86;84;10451929;10454396;2467
"12241";40;1;38;85;10457844;10460579;2735
"12421";40;3;88;86;10468666;10475637;6971
"12536";40;1;30;87;10479060;10483362;4302
"12720";40;1;2;88;10488189;10491945;3756
"12919";40;3;72;89;10502832;10509719;6887
"13036";40;1;46;90;10512008;10515119;3111
"13124";40;3;4;91;10518515;10522519;4004
"13320";40;3;8;92;10531288;10537285;5997
"13537";40;3;36;93;10542221;10547184;4963
"13738";40;3;48;94;10554471;10560967;6496
"13836";40;1;78;95;10595207;10598908;3701
"13939";40;1;26;96;10601127;10604016;2889
"14123";40;1;18;97;10609305;10612299;2994
"14338";40;3;40;98;10617093;10620990;3897
"14538";40;3;20;99;10625359;10629290;3931
"14738";40;3;24;100;10633876;10637731;3855
"9134";41;3;63;1;11102828;11111210;8382
"10137";41;3;79;2;11114478;11122151;7673
"11152";41;3;43;3;11124522;11133596;9074
"12152";41;3;67;4;11135958;11150102;14144
"13104";41;1;69;5;11152273;11159225;6952
"1496";41;3;11;6;11161784;11176466;14682
"1619";41;1;5;7;11185243;11192773;7530
"1820";41;3;31;8;11200351;11210606;10255
"2020";41;1;21;9;11218303;11226789;8486
"2240";41;3;59;10;11234661;11248908;14247
"2320";41;1;89;11;11252379;11257093;4714
"2439";41;1;65;12;11259353;11264429;5076
"2539";41;1;13;13;11266727;11273895;7168
"2740";41;3;75;14;11279430;11295295;15865
"2821";41;3;83;15;11299325;11306928;7603
"2938";41;3;55;16;11310605;11319002;8397
"3021";41;1;33;17;11321215;11326281;5066
"3221";41;1;81;18;11331550;11337893;6343
"3339";41;1;93;19;11340264;11353826;13562
"3439";41;3;27;20;11356210;11366924;10714
"3621";41;3;91;21;11373017;11380042;7025
"3739";41;3;15;22;11382395;11390208;7813
"3940";41;1;9;23;11400112;11405682;5570
"4140";41;3;95;24;11411448;11418615;7167
"4238";41;1;57;25;11420872;11426290;5418
"4322";41;1;41;26;11428582;11434025;5443
"4437";41;1;49;27;11436274;11444161;7887
"4522";41;1;73;28;11446640;11453906;7266
"4638";41;1;61;29;11456081;11462972;6891
"4740";41;1;97;30;11465517;11473155;7638
"4822";41;1;53;31;11475706;11483638;7932
"4937";41;3;99;32;11486097;11498454;12357
"5040";41;3;51;33;11501097;11509190;8093
"5140";41;1;85;34;11511540;11518429;6889
"5240";41;1;37;35;11520906;11527228;6322
"5421";41;3;87;36;11533246;11540386;7140
"5538";41;1;29;37;11543088;11558477;15389
"5722";41;1;1;38;11564441;11572122;7681
"5922";41;3;71;39;11578051;11584884;6833
"6037";41;1;45;40;11587316;11592234;4918
"6122";41;3;3;41;11595721;11605003;9282
"6321";41;3;7;42;11610221;11619092;8871
"6539";41;3;35;43;11624390;11632958;8568
"6740";41;3;47;44;11638797;11645063;6266
"6839";41;1;77;45;11647564;11652799;5235
"6940";41;1;25;46;11655024;11660949;5925
"7122";41;1;17;47;11666674;11673065;6391
"7338";41;3;39;48;11918100;11925611;7511
"7540";41;3;19;49;11930843;11938024;7181
"7738";41;3;23;50;11946472;11954315;7843
"7938";41;2;98;51;11960075;11964598;4523
"8038";41;4;84;52;11967122;11974014;6892
"8140";41;2;82;53;11976796;11981055;4259
"8239";41;2;10;54;11983579;11988814;5235
"8439";41;4;92;55;11996416;12003952;7536
"8523";41;4;36;56;12006718;12012641;5923
"8720";41;2;38;57;12019123;12023404;4281
"8920";41;4;8;58;12100779;12111218;10439
"9135";41;2;54;59;12122225;12129118;6893
"9239";41;4;20;60;12251499;12259913;8414
"9440";41;4;48;61;12265777;12274921;9144
"9540";41;4;56;62;12277464;12284946;7482
"9623";41;4;44;63;12288496;12299687;11191
"9738";41;4;24;64;12334315;12345668;11353
"9939";41;4;40;65;12351249;12358093;6844
"10138";41;2;2;66;12362967;12370226;7259
"10336";41;4;72;67;12376463;12386250;9787
"10440";41;4;100;68;12388703;12396541;7838
"10523";41;4;16;69;12399051;12406844;7793
"10736";41;4;52;70;12413260;12422066;8806
"10824";41;2;62;71;12424443;12428724;4281
"10938";41;2;78;72;12431074;12436890;5816
"11021";41;4;96;73;12439249;12446948;7699
"11153";41;4;60;74;12449427;12456164;6737
"11239";41;4;12;75;12458521;12464981;6460
"11439";41;2;26;76;12470765;12476563;5798
"11640";41;2;86;77;12482412;12487968;5556
"11740";41;2;34;78;12490477;12496073;5596
"11940";41;4;68;79;12501813;12508490;6677
"12040";41;4;80;80;12510881;12522874;11993
"12153";41;2;94;81;12525327;12531278;5951
"12242";41;2;66;82;12533634;12541270;7636
"12326";41;2;18;83;12543987;12549700;5713
"12537";41;2;58;84;12554740;12560494;5754
"12624";41;2;6;85;12562715;12568669;5954
"12821";41;4;4;86;12574511;12582018;7507
"13037";41;4;28;87;12587590;12595484;7894
"13225";41;2;22;88;12601414;12605496;4082
"13421";41;4;76;89;12611205;12617375;6170
"13538";41;2;74;90;12619703;12624591;4888
"13621";41;4;88;91;12627003;12633826;6823
"13739";41;2;46;92;12636125;12642035;5910
"13837";41;4;64;93;12644277;12651591;7314
"13940";41;2;42;94;12654135;12657649;3514
"14023";41;2;30;95;12659838;12663215;3377
"14224";41;2;70;96;12668147;12680156;12009
"14339";41;2;50;97;12682404;12688998;6594
"14421";41;2;90;98;12691667;12696430;4763
"14539";41;4;32;99;12698793;12705372;6579
"14739";41;2;14;100;12710888;12715447;4559
"9136";42;2;97;1;1011509;1016059;4550
"10139";42;4;83;2;1019473;1025450;5977
"11154";42;2;81;3;1029208;1033008;3800
"12154";42;2;9;4;1036132;1039733;3601
"1497";42;4;91;5;1047507;1053474;5967
"1521";42;4;35;6;1055873;1061982;6109
"1721";42;2;37;7;1068162;1072181;4019
"1920";42;4;7;8;1078827;1084773;5946
"2121";42;2;53;9;1094208;1100197;5989
"2241";42;4;19;10;1103136;1109589;6453
"2440";42;4;47;11;1115424;1119430;4006
"2540";42;4;55;12;1122821;1126663;3842
"2621";42;4;43;13;1129138;1136021;6883
"2741";42;4;23;14;1138531;1143529;4998
"2939";42;4;39;15;1180411;1185469;5058
"3120";42;2;1;16;1192001;1201294;9293
"3340";42;4;71;17;1207476;1211818;4342
"3440";42;4;99;18;1214021;1219609;5588
"3521";42;4;15;19;1221865;1227684;5819
"3740";42;4;51;20;1233335;1240226;6891
"3821";42;2;61;21;1242340;1247351;5011
"3941";42;2;77;22;1250811;1254892;4081
"4021";42;4;95;23;1257330;1266008;8678
"4141";42;4;59;24;1269047;1272900;3853
"4239";42;4;11;25;1277060;1282141;5081
"4438";42;2;25;26;1287529;1291907;4378
"4639";42;2;85;27;1298812;1303757;4945
"4741";42;2;33;28;1306841;1310040;3199
"4938";42;4;67;29;1315795;1322014;6219
"5041";42;4;79;30;1324328;1329964;5636
"5141";42;2;93;31;1332217;1336930;4713
"5241";42;2;65;32;1339341;1344747;5406
"5321";42;2;17;33;1347325;1351705;4380
"5539";42;2;57;34;1357120;1361155;4035
"5620";42;2;5;35;1363975;1368538;4563
"5818";42;4;3;36;1374926;1380171;5245
"6038";42;4;27;37;1387773;1393186;5413
"6219";42;2;21;38;1398777;1402786;4009
"6419";42;4;75;39;1407649;1415344;7695
"6540";42;2;73;40;1418616;1423460;4844
"6621";42;4;87;41;1426052;1431069;5017
"6741";42;2;45;42;1435838;1439019;3181
"6840";42;4;63;43;1441726;1446185;4459
"6941";42;2;41;44;1449098;1452868;3770
"7021";42;2;29;45;1456381;1460701;4320
"7219";42;2;69;46;1466267;1471059;4792
"7339";42;2;49;47;1473516;1477545;4029
"7421";42;2;89;48;1506392;1510049;3657
"7541";42;4;31;49;1512611;1517566;4955
"7739";42;2;13;50;1521970;1526140;4170
"7939";42;1;64;51;1531720;1536940;5220
"8039";42;1;80;52;1539467;1543714;4247
"8141";42;1;44;53;1546017;1549948;3931
"8240";42;1;68;54;1553690;1558181;4491
"8320";42;3;70;55;1560559;1565881;5322
"8440";42;1;12;56;1568060;1574022;5962
"8620";42;3;6;57;1580828;1585613;4785
"8820";42;1;32;58;1591376;1595088;3712
"9020";42;3;22;59;1600578;1607296;6718
"9240";42;1;60;60;1615104;1619654;4550
"9323";42;3;90;61;1621889;1627012;5123
"9441";42;3;66;62;1629426;1634661;5235
"9541";42;3;14;63;1637739;1644177;6438
"9739";42;1;76;64;1648899;1653319;4420
"9820";42;1;84;65;1655832;1660435;4603
"9940";42;1;56;66;1662942;1666660;3718
"10020";42;3;34;67;1668967;1673301;4334
"10224";42;3;82;68;1678317;1683051;4734
"10337";42;3;94;69;1685855;1691509;5654
"10441";42;1;28;70;1694113;1699501;5388
"10622";42;1;92;71;1705470;1710209;4739
"10737";42;1;16;72;1712928;1717500;4572
"10939";42;3;10;73;1722748;1728758;6010
"11155";42;1;96;74;1735776;1739641;3865
"11240";42;3;58;75;1741785;1747549;5764
"11324";42;3;42;76;1749769;1756207;6438
"11440";42;3;50;77;1758684;1764948;6264
"11522";42;3;74;78;1767250;1772540;5290
"11641";42;3;62;79;1774921;1779448;4527
"11741";42;3;98;80;1781698;1786806;5108
"11821";42;3;54;81;1790351;1795436;5085
"11941";42;1;100;82;1840415;1843679;3264
"12041";42;1;52;83;1846638;1851045;4407
"12155";42;3;86;84;1853337;1857887;4550
"12243";42;3;38;85;1860737;1865061;4324
"12422";42;1;88;86;1870831;1876311;5480
"12538";42;3;30;87;1880096;1884211;4115
"12721";42;3;2;88;1889779;1895894;6115
"12920";42;1;72;89;1946677;1953017;6340
"13038";42;3;46;90;1955528;1960799;5271
"13125";42;1;4;91;1963943;1967266;3323
"13321";42;1;8;92;1973111;1978924;5813
"13539";42;1;36;93;1985005;1990173;5168
"13740";42;1;48;94;1997718;2001606;3888
"13838";42;3;78;95;2004983;2009889;4906
"13941";42;3;26;96;2013967;2018781;4814
"14124";42;3;18;97;2025363;2029997;4634
"14340";42;1;40;98;2036288;2041072;4784
"14540";42;1;20;99;2046361;2050363;4002
"14740";42;1;24;100;2057630;2062221;4591
"9137";43;1;63;1;3338878;3342791;3913
"10140";43;1;79;2;3347303;3351593;4290
"11156";43;1;43;3;3354468;3357809;3341
"12156";43;1;67;4;3360404;3364081;3677
"13105";43;3;69;5;3369724;3376673;6949
"1498";43;1;11;6;3381004;3384916;3912
"1620";43;3;5;7;3391855;3397241;5386
"1821";43;1;31;8;3405956;3410207;4251
"2021";43;3;21;9;3418057;3422882;4825
"2242";43;1;59;10;3430767;3434566;3799
"2321";43;3;89;11;3440667;3445572;4905
"2441";43;3;65;12;3448183;3453514;5331
"2541";43;3;13;13;3456042;3461136;5094
"2742";43;1;75;14;3469796;3474929;5133
"2822";43;1;83;15;3478325;3481780;3455
"2940";43;1;55;16;3484971;3489696;4725
"3022";43;3;33;17;3493543;3498612;5069
"3222";43;3;81;18;3503956;3509237;5281
"3341";43;3;93;19;3511751;3517062;5311
"3441";43;1;27;20;3520012;3523828;3816
"3622";43;1;91;21;3533136;3537269;4133
"3741";43;1;15;22;3539280;3543286;4006
"3942";43;3;9;23;3550108;3554868;4760
"4142";43;1;95;24;3561670;3565868;4198
"4240";43;3;57;25;3567938;3573593;5655
"4323";43;3;41;26;3579590;3584734;5144
"4439";43;3;49;27;3587344;3592528;5184
"4523";43;3;73;28;3594823;3600842;6019
"4640";43;3;61;29;3603516;3608183;4667
"4742";43;3;97;30;3610430;3615242;4812
"4823";43;3;53;31;3621100;3627249;6149
"4939";43;1;99;32;3655845;3660005;4160
"5042";43;1;51;33;3662419;3667289;4870
"5142";43;3;85;34;3669661;3677339;7678
"5242";43;3;37;35;3679673;3686680;7007
"5422";43;1;87;36;3692798;3697013;4215
"5540";43;3;29;37;3699338;3705879;6541
"5723";43;3;1;38;3711098;3717196;6098
"5923";43;1;71;39;3723975;3728017;4042
"6039";43;3;45;40;3731036;3736187;5151
"6123";43;1;3;41;3738445;3743878;5433
"6322";43;1;7;42;3750001;3754564;4563
"6541";43;1;35;43;3760552;3765153;4601
"6742";43;1;47;44;3770574;3774277;3703
"6841";43;3;77;45;3776557;3780910;4353
"6942";43;3;25;46;3783615;3788918;5303
"7123";43;3;17;47;3793585;3798993;5408
"7340";43;1;39;48;3804452;3808534;4082
"7542";43;1;19;49;3813104;3816736;3632
"7740";43;1;23;50;3822964;3826617;3653
"7940";43;4;98;51;3833280;3837209;3929
"8040";43;2;84;52;3839711;3844416;4705
"8142";43;4;82;53;3846503;3850753;4250
"8241";43;4;10;54;3856747;3862524;5777
"8441";43;2;92;55;3868261;3872524;4263
"8524";43;2;36;56;3877618;3881439;3821
"8721";43;4;38;57;3886641;3890731;4090
"8921";43;2;8;58;3895790;3899821;4031
"9138";43;4;54;59;3905213;3909055;3842
"9241";43;2;20;60;3911978;3914838;2860
"9442";43;2;48;61;3921083;3924494;3411
"9542";43;2;56;62;3926808;3929599;2791
"9624";43;2;44;63;3932688;3935988;3300
"9740";43;2;24;64;3938106;3941271;3165
"9941";43;2;40;65;3946251;3948504;2253
"10141";43;4;2;66;3953672;3957537;3865
"10338";43;2;72;67;3964821;3969312;4491
"10442";43;2;100;68;3971463;3974619;3156
"10524";43;2;16;69;4013169;4016128;2959
"10738";43;2;52;70;4022958;4026104;3146
"10825";43;4;62;71;4029229;4033080;3851
"10940";43;4;78;72;4035883;4040161;4278
"11022";43;2;96;73;4042550;4044852;2302
"11157";43;2;60;74;4047891;4051073;3182
"11241";43;2;12;75;4054238;4057161;2923
"11441";43;4;26;76;4067910;4071701;3791
"11642";43;4;86;77;4079061;4081968;2907
"11742";43;4;34;78;4084293;4088876;4583
"11942";43;2;68;79;4094313;4098392;4079
"12042";43;2;80;80;4100726;4103701;2975
"12157";43;4;94;81;4107211;4110633;3422
"12244";43;4;66;82;4113088;4116637;3549
"12327";43;4;18;83;4122828;4126216;3388
"12539";43;4;58;84;4131707;4135199;3492
"12625";43;4;6;85;4137344;4140655;3311
"12822";43;2;4;86;4145820;4148392;2572
"13039";43;2;28;87;4154191;4158090;3899
"13226";43;4;22;88;4164809;4168014;3205
"13422";43;2;76;89;4175191;4178206;3015
"13540";43;4;74;90;4181675;4185131;3456
"13622";43;2;88;91;4188723;4191930;3207
"13741";43;4;46;92;4196649;4200397;3748
"13839";43;2;64;93;4261309;4264478;3169
"13942";43;4;42;94;4268638;4272119;3481
"14024";43;4;30;95;4274629;4277494;2865
"14225";43;4;70;96;4283133;4286518;3385
"14341";43;4;50;97;4288853;4292877;4024
"14422";43;4;90;98;4295382;4298435;3053
"14541";43;2;32;99;4300888;4303368;2480
"14741";43;4;14;100;4308722;4312442;3720
"9139";44;4;97;1;6719019;6722567;3548
"10142";44;2;83;2;6724735;6726921;2186
"11158";44;4;81;3;6729164;6732258;3094
"12158";44;4;9;4;6734455;6737561;3106
"1499";44;2;91;5;6743797;6746850;3053
"1522";44;2;35;6;6749095;6751833;2738
"1722";44;4;37;7;6758946;6762765;3819
"1921";44;2;7;8;6769720;6772732;3012
"2122";44;4;53;9;6779890;6783423;3533
"2243";44;2;19;10;6787000;6790638;3638
"2442";44;2;47;11;6797886;6800973;3087
"2542";44;2;55;12;6807007;6808572;1565
"2622";44;2;43;13;6820827;6825096;4269
"2743";44;2;23;14;6827888;6832055;4167
"2941";44;2;39;15;6837406;6840480;3074
"3121";44;4;1;16;6846328;6850888;4560
"3342";44;2;71;17;6857891;6860882;2991
"3442";44;2;99;18;6863644;6866562;2918
"3522";44;2;15;19;6868946;6872403;3457
"3742";44;2;51;20;6878592;6882011;3419
"3822";44;4;61;21;6884267;6887869;3602
"3943";44;4;77;22;6890740;6893919;3179
"4022";44;2;95;23;6897598;6900701;3103
"4143";44;2;59;24;6903748;6906577;2829
"4241";44;2;11;25;6909407;6912581;3174
"4440";44;4;25;26;6919254;6923230;3976
"4641";44;4;85;27;6928423;6932143;3720
"4743";44;4;33;28;6935582;6938768;3186
"4940";44;2;67;29;6945679;6948760;3081
"5043";44;2;79;30;6951636;6954200;2564
"5143";44;4;93;31;6957038;6960112;3074
"5243";44;4;65;32;6963616;6967434;3818
"5322";44;4;17;33;6970363;6973857;3494
"5541";44;4;57;34;6979579;6983224;3645
"5621";44;4;5;35;6985731;6988522;2791
"5819";44;2;3;36;6996071;6998402;2331
"6040";44;2;27;37;7029917;7034247;4330
"6220";44;4;21;38;7121158;7124638;3480
"6420";44;2;75;39;7131813;7134888;3075
"6542";44;4;73;40;7137737;7141404;3667
"6622";44;2;87;41;7144590;7147312;2722
"6743";44;4;45;42;7149591;7152775;3184
"6842";44;2;63;43;7158040;7161062;3022
"6943";44;4;41;44;7168515;7171561;3046
"7022";44;4;29;45;7176655;7180307;3652
"7220";44;4;69;46;7185607;7190634;5027
"7341";44;4;49;47;7193629;7197578;3949
"7422";44;4;89;48;7200271;7203777;3506
"7543";44;2;31;49;7206889;7210418;3529
"7741";44;4;13;50;7248558;7252350;3792
"7941";44;3;64;51;7259016;7263733;4717
"8041";44;3;80;52;7268726;7273783;5057
"8143";44;3;44;53;7277643;7281881;4238
"8242";44;3;68;54;7284328;7289857;5529
"8321";44;1;70;55;7293429;7296999;3570
"8442";44;3;12;56;7302023;7306882;4859
"8621";44;1;6;57;7312163;7315156;2993
"8821";44;3;32;58;7321107;7324723;3616
"9021";44;1;22;59;7330097;7333123;3026
"9242";44;3;60;60;7339520;7343980;4460
"9324";44;1;90;61;7347280;7350989;3709
"9443";44;1;66;62;7353819;7357580;3761
"9543";44;1;14;63;7359931;7363230;3299
"9741";44;3;76;64;7368747;7372655;3908
"9821";44;3;84;65;7375307;7379727;4420
"9942";44;3;56;66;7387000;7389812;2812
"10021";44;1;34;67;7392529;7396224;3695
"10225";44;1;82;68;7402361;7405680;3319
"10339";44;1;94;69;7408368;7411873;3505
"10443";44;3;28;70;7415859;7421086;5227
"10623";44;3;92;71;7427824;7431594;3770
"10739";44;3;16;72;7434077;7438587;4510
"10941";44;1;10;73;7444235;7447604;3369
"11159";44;3;96;74;7454337;7458468;4131
"11242";44;1;58;75;7460934;7464534;3600
"11325";44;1;42;76;7467249;7470018;2769
"11442";44;1;50;77;7474316;7478184;3868
"11523";44;1;74;78;7480981;7483942;2961
"11643";44;1;62;79;7487089;7489675;2586
"11743";44;1;98;80;7492685;7495533;2848
"11822";44;1;54;81;7498066;7501341;3275
"11943";44;3;100;82;7503790;7508366;4576
"12043";44;3;52;83;7511815;7517083;5268
"12159";44;1;86;84;7519534;7522874;3340
"12245";44;1;38;85;7526691;7529507;2816
"12423";44;3;88;86;7561196;7565571;4375
"12540";44;1;30;87;7568083;7571514;3431
"12722";44;1;2;88;7577212;7580422;3210
"12921";44;3;72;89;7590387;7594005;3618
"13040";44;1;46;90;7596584;7599888;3304
"13126";44;3;4;91;7604081;7608538;4457
"13322";44;3;8;92;7614843;7619154;4311
"13541";44;3;36;93;7625414;7629528;4114
"13742";44;3;48;94;7635421;7640072;4651
"13840";44;1;78;95;7647320;7650620;3300
"13943";44;1;26;96;7653415;7656369;2954
"14125";44;1;18;97;7666057;7669194;3137
"14342";44;3;40;98;7682821;7685618;2797
"14542";44;3;20;99;7690915;7695009;4094
"14742";44;3;24;100;7701609;7705559;3950
"9140";45;3;63;1;459349;465580;6231
"10143";45;3;79;2;468306;475212;6906
"11160";45;3;43;3;477760;483912;6152
"12160";45;3;67;4;486288;493737;7449
"13106";45;1;69;5;495982;501878;5896
"14100";45;3;11;6;504130;510895;6765
"1621";45;1;5;7;516716;521594;4878
"1822";45;3;31;8;527181;533768;6587
"2022";45;1;21;9;540001;544310;4309
"2244";45;3;59;10;550582;555276;4694
"2322";45;1;89;11;558218;563484;5266
"2443";45;1;65;12;565964;570784;4820
"2543";45;1;13;13;573245;578942;5697
"2744";45;3;75;14;585009;591492;6483
"2823";45;3;83;15;594127;599375;5248
"2942";45;3;55;16;601757;607824;6067
"3023";45;1;33;17;610234;615057;4823
"3223";45;1;81;18;620138;625665;5527
"3343";45;1;93;19;627807;633657;5850
"3443";45;3;27;20;636014;643290;7276
"3623";45;3;91;21;648589;655589;7000
"3743";45;3;15;22;657847;664039;6192
"3944";45;1;9;23;669149;673663;4514
"4144";45;3;95;24;679527;686680;7153
"4242";45;1;57;25;688863;695013;6150
"4324";45;1;41;26;697197;703487;6290
"4441";45;1;49;27;706112;711137;5025
"4524";45;1;73;28;713827;719104;5277
"4642";45;1;61;29;721445;726303;4858
"4744";45;1;97;30;728780;734136;5356
"4824";45;1;53;31;736718;742436;5718
"4941";45;3;99;32;744957;752736;7779
"5044";45;3;51;33;755110;763769;8659
"5144";45;1;85;34;765972;772302;6330
"5244";45;1;37;35;774716;779376;4660
"5423";45;3;87;36;785299;792784;7485
"5542";45;1;29;37;795130;801209;6079
"5724";45;1;1;38;806973;812384;5411
"5924";45;3;71;39;818577;826183;7606
"6041";45;1;45;40;828450;833724;5274
"6124";45;3;3;41;835989;843007;7018
"6323";45;3;7;42;848706;855082;6376
"6543";45;3;35;43;860808;868140;7332
"6744";45;3;47;44;874777;882597;7820
"6843";45;1;77;45;885074;890772;5698
"6944";45;1;25;46;893042;899139;6097
"7124";45;1;17;47;905435;911788;6353
"7342";45;3;39;48;970473;977611;7138
"7544";45;3;19;49;983914;990518;6604
"7742";45;3;23;50;997885;1005402;7517
"7942";45;2;98;51;1011436;1015276;3840
"8042";45;4;84;52;1049451;1056891;7440
"8144";45;2;82;53;1059269;1064932;5663
"8243";45;2;10;54;1067426;1072907;5481
"8443";45;4;92;55;1078228;1085482;7254
"8525";45;4;36;56;1087652;1093781;6129
"8722";45;2;38;57;1099615;1104198;4583
"8922";45;4;8;58;1109780;1116356;6576
"9141";45;2;54;59;1124465;1130155;5690
"9243";45;4;20;60;1132525;1138180;5655
"9444";45;4;48;61;1143147;1148863;5716
"9544";45;4;56;62;1151253;1157496;6243
"9625";45;4;44;63;1159841;1166629;6788
"9742";45;4;24;64;1169084;1175778;6694
"9943";45;4;40;65;1181545;1186736;5191
"10144";45;2;2;66;1191680;1196586;4906
"10340";45;4;72;67;1202991;1210577;7586
"10444";45;4;100;68;1212974;1218510;5536
"10525";45;4;16;69;1221953;1228960;7007
"10740";45;4;52;70;1234741;1243101;8360
"10826";45;2;62;71;1246133;1250867;4734
"10942";45;2;78;72;1254033;1259225;5192
"11023";45;4;96;73;1262407;1267867;5460
"11161";45;4;60;74;1271188;1277283;6095
"11243";45;4;12;75;1280472;1287882;7410
"11443";45;2;26;76;1294589;1299999;5410
"11644";45;2;86;77;1305270;1310490;5220
"11744";45;2;34;78;1316038;1322356;6318
"11944";45;4;68;79;1329196;1334981;5785
"12044";45;4;80;80;1337551;1344314;6763
"12161";45;2;94;81;1346583;1351864;5281
"12246";45;2;66;82;1354162;1359663;5501
"12328";45;2;18;83;1362030;1367138;5108
"12541";45;2;58;84;1371817;1376871;5054
"12626";45;2;6;85;1379119;1384937;5818
"12823";45;4;4;86;1389854;1396404;6550
"13041";45;4;28;87;1401274;1409320;8046
"13227";45;2;22;88;1414731;1419086;4355
"13423";45;4;76;89;1424450;1429427;4977
"13542";45;2;74;90;1432123;1437610;5487
"13623";45;4;88;91;1440885;1447710;6825
"13743";45;2;46;92;1450160;1455601;5441
"13841";45;4;64;93;1458971;1466901;7930
"13944";45;2;42;94;1469221;1473534;4313
"14025";45;2;30;95;1475732;1479775;4043
"14226";45;2;70;96;1485161;1491326;6165
"14343";45;2;50;97;1494607;1500650;6043
"14423";45;2;90;98;1503471;1509299;5828
"14543";45;4;32;99;1514871;1521316;6445
"14743";45;2;14;100;1527530;1531598;4068
"9142";46;2;97;1;2046818;2056740;9922
"10145";46;4;83;2;2059289;2067689;8400
"11162";46;2;81;3;2070791;2076277;5486
"12162";46;2;9;4;2083096;2089757;6661
"14101";46;4;91;5;2100134;2113535;13401
"1523";46;4;35;6;2117087;2124821;7734
"1723";46;2;37;7;2130522;2138104;7582
"1922";46;4;7;8;2147306;2157553;10247
"2123";46;2;53;9;2165700;2171335;5635
"2245";46;4;19;10;2173987;2184187;10200
"2444";46;4;47;11;2190737;2200559;9822
"2544";46;4;55;12;2203586;2212934;9348
"2623";46;4;43;13;2216092;2224275;8183
"2745";46;4;23;14;2227981;2236858;8877
"2943";46;4;39;15;2244202;2256616;12414
"3122";46;2;1;16;2263056;2272215;9159
"3344";46;4;71;17;2282679;2291882;9203
"3444";46;4;99;18;2295748;2305480;9732
"3523";46;4;15;19;2310474;2319688;9214
"3744";46;4;51;20;2367799;2376969;9170
"3823";46;2;61;21;2381205;2387827;6622
"3945";46;2;77;22;2395712;2405314;9602
"4023";46;4;95;23;2415084;2425700;10616
"4145";46;4;59;24;2432874;2445109;12235
"4243";46;4;11;25;2451463;2461491;10028
"4442";46;2;25;26;2473469;2481491;8022
"4643";46;2;85;27;2488003;2495248;7245
"4745";46;2;33;28;2499414;2509648;10234
"4942";46;4;67;29;2517353;2528006;10653
"5045";46;4;79;30;2533944;2543122;9178
"5145";46;2;93;31;2550042;2559468;9426
"5245";46;2;65;32;2563924;2573509;9585
"5323";46;2;17;33;2581501;2589045;7544
"5543";46;2;57;34;2631180;2639713;8533
"5622";46;2;5;35;2643154;2652668;9514
"5820";46;4;3;36;2663903;2673400;9497
"6042";46;4;27;37;2680512;2692725;12213
"6221";46;2;21;38;2700961;2709207;8246
"6421";46;4;75;39;2715598;2729098;13500
"6544";46;2;73;40;2732310;2741814;9504
"6623";46;4;87;41;2745275;2754697;9422
"6745";46;2;45;42;2759982;2770522;10540
"6844";46;4;63;43;2773333;2785113;11780
"6945";46;2;41;44;2789387;2797262;7875
"7023";46;2;29;45;2802344;2815578;13234
"7221";46;2;69;46;2822109;2830969;8860
"7343";46;2;49;47;2835691;2845911;10220
"7423";46;2;89;48;2984673;2990499;5826
"7545";46;4;31;49;2993818;3003155;9337
"7743";46;2;13;50;3010416;3021621;11205
"7943";46;1;64;51;3028040;3039014;10974
"8043";46;1;80;52;3044214;3056630;12416
"8244";46;1;44;54;3122931;3130557;7626
"8322";46;1;68;55;3136134;3145793;9659
"8444";46;3;70;56;3149498;3164418;14920
"8526";46;1;12;57;3168727;3180758;12031
"8723";46;3;6;58;3260580;3267793;7213
"8923";46;1;32;59;3273308;3280250;6942
"9143";46;3;22;60;3285771;3294117;8346
"9325";46;1;60;61;3300612;3307824;7212
"9445";46;3;90;62;3310948;3318408;7460
"9545";46;3;66;63;3321108;3335915;14807
"9626";46;3;14;64;3340575;3357473;16898
"9822";46;1;76;65;3363980;3370855;6875
"9944";46;1;84;66;3373677;3383222;9545
"10022";46;1;56;67;3386496;3394829;8333
"10146";46;3;34;68;3399525;3408523;8998
"10341";46;3;82;69;3414765;3423612;8847
"10445";46;3;94;70;3428024;3436836;8812
"10526";46;1;28;71;3439794;3453102;13308
"10741";46;1;92;72;3459132;3469377;10245
"10827";46;1;16;73;3477144;3488248;11104
"11024";46;3;10;74;3495886;3507259;11373
"11244";46;1;96;75;3518831;3530651;11820
"11326";46;3;58;76;3540342;3550060;9718
"11444";46;3;42;77;3553770;3568282;14512
"11524";46;3;50;78;3572437;3581231;8794
"11645";46;3;74;79;3584267;3592506;8239
"11745";46;3;62;80;3596007;3603600;7593
"11823";46;3;98;81;3606336;3614030;7694
"11945";46;3;54;82;3619810;3634671;14861
"12045";46;1;100;83;3638944;3645915;6971
"12163";46;1;52;84;3649261;3658370;9109
"12247";46;3;86;85;3727675;3734242;6567
"12329";46;3;38;86;3736869;3743809;6940
"12542";46;1;88;87;3750373;3756533;6160
"12627";46;3;30;88;3759929;3769211;9282
"12824";46;3;2;89;3775649;3783599;7950
"13042";46;1;72;90;3791018;3802340;11322
"13127";46;3;46;91;3806647;3815664;9017
"13228";46;1;4;92;3818161;3827372;9211
"13424";46;1;8;93;3833964;3841189;7225
"13624";46;1;36;94;3847511;3855188;7677
"13842";46;1;48;95;3863032;3869329;6297
"13945";46;3;78;96;3871781;3880287;8506
"14026";46;3;26;97;3882929;3891115;8186
"14227";46;3;18;98;3896795;3906116;9321
"14424";46;1;40;99;3913241;3922557;9316
"14610";46;1;20;100;3927165;3933319;6154
"14810";46;1;24;101;3938326;3947063;8737
"9144";47;1;63;1;4401159;4404028;2869
"10147";47;1;79;2;4406402;4410120;3718
"11163";47;1;43;3;4413039;4416584;3545
"12164";47;1;67;4;4418763;4422286;3523
"13107";47;3;69;5;4424422;4428719;4297
"14102";47;1;11;6;4430887;4434336;3449
"1622";47;3;5;7;4439904;4443818;3914
"1823";47;1;31;8;4449255;4453076;3821
"2023";47;3;21;9;4458398;4464051;5653
"2246";47;1;59;10;4472058;4474901;2843
"2323";47;3;89;11;4477910;4481242;3332
"2445";47;3;65;12;4483415;4486981;3566
"2545";47;3;13;13;4489287;4493813;4526
"2746";47;1;75;14;4499206;4504866;5660
"2824";47;1;83;15;4507933;4509974;2041
"2944";47;1;55;16;4514923;4518582;3659
"3024";47;3;33;17;4522005;4525665;3660
"3224";47;3;81;18;4530629;4534928;4299
"3345";47;3;93;19;4537403;4540989;3586
"3445";47;1;27;20;4543627;4547665;4038
"3624";47;1;91;21;4552601;4556023;3422
"3745";47;1;15;22;4558709;4561806;3097
"3946";47;3;9;23;4568950;4572256;3306
"4146";47;1;95;24;4580882;4584755;3873
"4244";47;3;57;25;4587365;4593452;6087
"4325";47;3;41;26;4595899;4599455;3556
"4443";47;3;49;27;4602579;4607637;5058
"4525";47;3;73;28;4610121;4614662;4541
"4644";47;3;61;29;4618051;4622337;4286
"4746";47;3;97;30;4624723;4629845;5122
"4825";47;3;53;31;4632252;4637570;5318
"4943";47;1;99;32;4640195;4643918;3723
"5046";47;1;51;33;4646888;4650599;3711
"5146";47;3;85;34;4652795;4658968;6173
"5246";47;3;37;35;4661263;4665585;4322
"5424";47;1;87;36;4671917;4675443;3526
"5544";47;3;29;37;4677699;4682310;4611
"5725";47;3;1;38;4688362;4692093;3731
"5925";47;1;71;39;4697126;4700467;3341
"6043";47;3;45;40;4702908;4707609;4701
"6125";47;1;3;41;4709765;4712534;2769
"6324";47;1;7;42;4718135;4721732;3597
"6545";47;1;35;43;4728273;4731991;3718
"6746";47;1;47;44;4737494;4741758;4264
"6845";47;3;77;45;4744098;4748699;4601
"6946";47;3;25;46;4751256;4758207;6951
"7125";47;3;17;47;4763248;4766773;3525
"7344";47;1;39;48;4834775;4838196;3421
"7546";47;1;19;49;4844368;4847661;3293
"7744";47;1;23;50;4853674;4856178;2504
"7944";47;4;98;51;4862361;4867611;5250
"8044";47;2;84;52;4870388;4873983;3595
"8145";47;4;82;53;4876581;4880479;3898
"8245";47;4;10;54;4883303;4888727;5424
"8445";47;2;92;55;4929660;4934609;4949
"8527";47;2;36;56;4940578;4943179;2601
"8724";47;4;38;57;4948830;4953575;4745
"8924";47;2;8;58;4993416;4996687;3271
"9145";47;4;54;59;5004231;5009240;5009
"9244";47;2;20;60;5012014;5016606;4592
"9446";47;2;48;61;5024127;5027764;3637
"9546";47;2;56;62;5030307;5032806;2499
"9627";47;2;44;63;5035733;5039129;3396
"9743";47;2;24;64;5041459;5045213;3754
"9945";47;2;40;65;5051113;5053221;2108
"10148";47;4;2;66;5058390;5061946;3556
"10342";47;2;72;67;5068445;5072554;4109
"10446";47;2;100;68;5076557;5079444;2887
"10527";47;2;16;69;5082521;5086613;4092
"10742";47;2;52;70;5092576;5095745;3169
"10828";47;4;62;71;5098698;5102349;3651
"10943";47;4;78;72;5105474;5108895;3421
"11025";47;2;96;73;5111623;5114069;2446
"11164";47;2;60;74;5116589;5118602;2013
"11245";47;2;12;75;5122594;5125877;3283
"11445";47;4;26;76;5131068;5134410;3342
"11646";47;4;86;77;5140805;5144668;3863
"11746";47;4;34;78;5148794;5153721;4927
"11946";47;2;68;79;5159177;5161909;2732
"12046";47;2;80;80;5164511;5167450;2939
"12165";47;4;94;81;5170161;5175259;5098
"12248";47;4;66;82;5177520;5182850;5330
"12330";47;4;18;83;5186608;5191891;5283
"12543";47;4;58;84;5197318;5202241;4923
"12628";47;4;6;85;5204792;5208924;4132
"12825";47;2;4;86;5213558;5216482;2924
"13043";47;2;28;87;5221656;5225815;4159
"13229";47;4;22;88;5230887;5236573;5686
"13425";47;2;76;89;5244974;5249135;4161
"13543";47;4;74;90;5252419;5256756;4337
"13625";47;2;88;91;5259454;5263160;3706
"13744";47;4;46;92;5266726;5271788;5062
"13843";47;2;64;93;5274235;5277514;3279
"13946";47;4;42;94;5279913;5285638;5725
"14027";47;4;30;95;5287758;5292471;4713
"14228";47;4;70;96;5299098;5303729;4631
"14344";47;4;50;97;5306229;5310604;4375
"14425";47;4;90;98;5313115;5317945;4830
"14544";47;2;32;99;5320179;5322870;2691
"14744";47;4;14;100;5327888;5331736;3848
"9146";48;4;97;1;5697731;5702251;4520
"10149";48;2;83;2;5704482;5708792;4310
"11165";48;4;81;3;5712016;5716283;4267
"12166";48;4;9;4;5719164;5722633;3469
"14103";48;2;91;5;5728579;5731018;2439
"1524";48;2;35;6;5733850;5737546;3696
"1724";48;4;37;7;5742733;5746163;3430
"1923";48;2;7;8;5751871;5754532;2661
"2124";48;4;53;9;5760282;5763189;2907
"2247";48;2;19;10;5765420;5769014;3594
"2446";48;2;47;11;5780287;5782906;2619
"2546";48;2;55;12;5785245;5789030;3785
"2624";48;2;43;13;5791283;5794838;3555
"2747";48;2;23;14;5797255;5799939;2684
"2945";48;2;39;15;5806010;5808375;2365
"3123";48;4;1;16;5814210;5820496;6286
"3346";48;2;71;17;5826881;5830336;3455
"3446";48;2;99;18;5832729;5835671;2942
"3524";48;2;15;19;5838901;5844770;5869
"3746";48;2;51;20;5850565;5855490;4925
"3824";48;4;61;21;5857837;5861466;3629
"3947";48;4;77;22;5863812;5867715;3903
"4024";48;2;95;23;5870692;5873563;2871
"4147";48;2;59;24;5876177;5879128;2951
"4245";48;2;11;25;5881303;5887069;5766
"4444";48;4;25;26;5895552;5901060;5508
"4645";48;4;85;27;5907439;5910893;3454
"4747";48;4;33;28;5913532;5916886;3354
"4944";48;2;67;29;5921821;5925218;3397
"5047";48;2;79;30;5927995;5931055;3060
"5147";48;4;93;31;5934132;5937375;3243
"5247";48;4;65;32;5940104;5944142;4038
"5324";48;4;17;33;5946492;5950592;4100
"5545";48;4;57;34;5955962;5959384;3422
"5623";48;4;5;35;5961759;5967191;5432
"5821";48;2;3;36;5971832;5974291;2459
"6044";48;2;27;37;5980535;5984165;3630
"6222";48;4;21;38;5989461;5992786;3325
"6422";48;2;75;39;5998559;6003012;4453
"6546";48;4;73;40;6006371;6009556;3185
"6624";48;2;87;41;6012316;6014788;2472
"6747";48;4;45;42;6017166;6020701;3535
"6846";48;2;63;43;6023166;6025497;2331
"6947";48;4;41;44;6028821;6032072;3251
"7024";48;4;29;45;6035269;6039159;3890
"7222";48;4;69;46;6044502;6048326;3824
"7345";48;4;49;47;6051469;6055921;4452
"7424";48;4;89;48;6124104;6127244;3140
"7547";48;2;31;49;6129638;6132900;3262
"7745";48;4;13;50;6137449;6140843;3394
"7945";48;3;64;51;6146124;6152076;5952
"8045";48;3;80;52;6154971;6159200;4229
"8146";48;3;44;53;6162204;6165659;3455
"8246";48;3;68;54;6167818;6171517;3699
"8323";48;1;70;55;6173726;6177734;4008
"8446";48;3;12;56;6180019;6183308;3289
"8622";48;1;6;57;6188520;6191368;2848
"8822";48;3;32;58;6196512;6200683;4171
"9022";48;1;22;59;6205593;6208066;2473
"9245";48;3;60;60;6213581;6216394;2813
"9326";48;1;90;61;6218703;6222298;3595
"9447";48;1;66;62;6224648;6228789;4141
"9547";48;1;14;63;6231431;6234157;2726
"9744";48;3;76;64;6240149;6243039;2890
"9823";48;3;84;65;6245940;6250004;4064
"9946";48;3;56;66;6252239;6255314;3075
"10023";48;1;34;67;6257515;6260105;2590
"10226";48;1;82;68;6264841;6267469;2628
"10343";48;1;94;69;6270039;6273389;3350
"10447";48;3;28;70;6275694;6280438;4744
"10624";48;3;92;71;6308965;6313095;4130
"10743";48;3;16;72;6316468;6320778;4310
"10944";48;1;10;73;6325968;6328887;2919
"11166";48;3;96;74;6334873;6341218;6345
"11246";48;1;58;75;6343488;6345661;2173
"11327";48;1;42;76;6348170;6350302;2132
"11446";48;1;50;77;6352454;6355300;2846
"11525";48;1;74;78;6358069;6360756;2687
"11647";48;1;62;79;6362925;6366203;3278
"11747";48;1;98;80;6368396;6370327;1931
"11824";48;1;54;81;6372395;6375348;2953
"11947";48;3;100;82;6377598;6379951;2353
"12047";48;3;52;83;6382874;6385493;2619
"12167";48;1;86;84;6387722;6390534;2812
"12249";48;1;38;85;6392616;6395126;2510
"12424";48;3;88;86;6401139;6403892;2753
"12544";48;1;30;87;6406685;6408958;2273
"12723";48;1;2;88;6414030;6416317;2287
"12922";48;3;72;89;6422879;6426552;3673
"13044";48;1;46;90;6429017;6431099;2082
"13128";48;3;4;91;6433410;6436793;3383
"13323";48;3;8;92;6443604;6448049;4445
"13544";48;3;36;93;6453485;6456362;2877
"13745";48;3;48;94;6463291;6466657;3366
"13844";48;1;78;95;6469148;6471590;2442
"13947";48;1;26;96;6473878;6476003;2125
"14126";48;1;18;97;6485773;6487773;2000
"14345";48;3;40;98;6492778;6495272;2494
"14545";48;3;20;99;6499705;6502838;3133
"14745";48;3;24;100;6508166;6511141;2975
"9147";49;3;63;1;7193112;7198553;5441
"10150";49;3;79;2;7202052;7207944;5892
"11167";49;3;43;3;7210724;7220010;9286
"12168";49;3;67;4;7223397;7230851;7454
"13108";49;1;69;5;7233346;7238834;5488
"14104";49;3;11;6;7241204;7248767;7563
"1623";49;1;5;7;7254915;7260125;5210
"1824";49;3;31;8;7266519;7276108;9589
"2024";49;1;21;9;7282485;7290316;7831
"2248";49;3;59;10;7298424;7304357;5933
"2324";49;1;89;11;7307195;7312240;5045
"2447";49;1;65;12;7315166;7321757;6591
"2547";49;1;13;13;7325384;7331473;6089
"2748";49;3;75;14;7337897;7343639;5742
"2825";49;3;83;15;7346589;7354680;8091
"2946";49;3;55;16;7357842;7364388;6546
"3025";49;1;33;17;7367154;7371888;4734
"3225";49;1;81;18;7422369;7426955;4586
"3347";49;1;93;19;7429973;7436130;6157
"3447";49;3;27;20;7439009;7445754;6745
"3625";49;3;91;21;7450787;7457888;7101
"3747";49;3;15;22;7460649;7466387;5738
"3948";49;1;9;23;7472377;7476154;3777
"4148";49;3;95;24;7481898;7487487;5589
"4246";49;1;57;25;7490119;7495578;5459
"4326";49;1;41;26;7498374;7503044;4670
"4445";49;1;49;27;7505744;7511377;5633
"4526";49;1;73;28;7513965;7519419;5454
"4646";49;1;61;29;7521975;7526776;4801
"4748";49;1;97;30;7529430;7534518;5088
"4826";49;1;53;31;7537190;7540943;3753
"4945";49;3;99;32;7543491;7550201;6710
"5048";49;3;51;33;7553094;7560134;7040
"5148";49;1;85;34;7562778;7568534;5756
"5248";49;1;37;35;7571390;7575867;4477
"5425";49;3;87;36;7581334;7588116;6782
"5546";49;1;29;37;7590657;7596724;6067
"5726";49;1;1;38;7601888;7606291;4403
"5926";49;3;71;39;7612368;7618015;5647
"6045";49;1;45;40;7620960;7625323;4363
"6126";49;3;3;41;7628180;7634681;6501
"6325";49;3;7;42;7640791;7646439;5648
"6547";49;3;35;43;7652228;7658047;5819
"6748";49;3;47;44;7664009;7669805;5796
"6847";49;1;77;45;7672939;7679771;6832
"6948";49;1;25;46;7682803;7689312;6509
"7126";49;1;17;47;7695441;7699820;4379
"7346";49;3;39;48;7757961;7763410;5449
"7548";49;3;19;49;7769297;7774810;5513
"7746";49;3;23;50;7780696;7787018;6322
"7946";49;2;98;51;7791984;7796342;4358
"8046";49;4;84;52;7798786;7807258;8472
"8147";49;2;82;53;7809843;7814033;4190
"8247";49;2;10;54;7816894;7823308;6414
"8447";49;4;92;55;7830199;7836915;6716
"8528";49;4;36;56;7839729;7847174;7445
"8725";49;2;38;57;7852792;7856373;3581
"8925";49;4;8;58;7861498;7868073;6575
"9148";49;2;54;59;7873712;7878631;4919
"9246";49;4;20;60;7881090;7887281;6191
"9448";49;4;48;61;7892642;7898788;6146
"9548";49;4;56;62;7901356;7907372;6016
"9628";49;4;44;63;7911829;7918854;7025
"9745";49;4;24;64;7922509;7929279;6770
"9947";49;4;40;65;7934603;7939895;5292
"10151";49;2;2;66;7944731;7949762;5031
"10344";49;4;72;67;7956058;7964903;8845
"10448";49;4;100;68;7967475;7973494;6019
"10528";49;4;16;69;7976117;7981844;5727
"10744";49;4;52;70;7987151;7993710;6559
"10829";49;2;62;71;7996483;8001560;5077
"10945";49;2;78;72;8004236;8010160;5924
"11026";49;4;96;73;8013322;8018543;5221
"11168";49;4;60;74;8022260;8026918;4658
"11247";49;4;12;75;8029303;8034742;5439
"11447";49;2;26;76;8040714;8044859;4145
"11648";49;2;86;77;8050333;8054091;3758
"11748";49;2;34;78;8056558;8060375;3817
"11948";49;4;68;79;8065966;8073907;7941
"12048";49;4;80;80;8076640;8083857;7217
"12169";49;2;94;81;8086440;8091282;4842
"12250";49;2;66;82;8093798;8102848;9050
"12331";49;2;18;83;8105738;8111015;5277
"12545";49;2;58;84;8116497;8121448;4951
"12629";49;2;6;85;8124028;8131189;7161
"12826";49;4;4;86;8136219;8142388;6169
"13045";49;4;28;87;8148372;8155546;7174
"13230";49;2;22;88;8161495;8164912;3417
"13426";49;4;76;89;8170828;8175712;4884
"13545";49;2;74;90;8179898;8183820;3922
"13626";49;4;88;91;8186261;8192095;5834
"13746";49;2;46;92;8194405;8198044;3639
"13845";49;4;64;93;8200715;8207969;7254
"13948";49;2;42;94;8210282;8214186;3904
"14028";49;2;30;95;8216583;8220136;3553
"14229";49;2;70;96;8225675;8230368;4693
"14346";49;2;50;97;8232952;8237385;4433
"14426";49;2;90;98;8240302;8245585;5283
"14546";49;4;32;99;8248115;8253701;5586
"14746";49;2;14;100;8259265;8264417;5152
"11169";50;2;97;1;994822;1004485;9663
"12170";50;4;83;2;1008519;1012191;3672
"13109";50;2;81;3;1016624;1034906;18282
"14105";50;2;9;4;1038056;1041359;3303
"1624";50;4;91;5;1048244;1053146;4902
"1725";50;4;35;6;1056007;1061450;5443
"1924";50;2;37;7;1066630;1069850;3220
"2125";50;4;7;8;1078827;1086149;7322
"2325";50;2;53;9;1139065;1142389;3324
"2448";50;4;19;10;1144718;1150797;6079
"2625";50;4;47;11;1166222;1169963;3741
"2749";50;4;55;12;1172189;1176538;4349
"2826";50;4;43;13;1178773;1186037;7264
"2947";50;4;23;14;1188457;1192539;4082
"3124";50;4;39;15;1198402;1202295;3893
"3348";50;2;1;16;1209576;1212845;3269
"3525";50;4;71;17;1229348;1237152;7804
"3626";50;4;99;18;1239556;1245810;6254
"3748";50;4;15;19;1248323;1252918;4595
"3949";50;4;51;20;1258706;1262313;3607
"4025";50;2;61;21;1265455;1270768;5313
"4149";50;2;77;22;1275262;1280501;5239
"4247";50;4;95;23;1283077;1289634;6557
"4327";50;4;59;24;1292485;1297075;4590
"4446";50;4;11;25;1299417;1304733;5316
"4647";50;2;25;26;1313826;1316669;2843
"4827";50;2;85;27;1322040;1325366;3326
"4946";50;2;33;28;1327841;1332782;4941
"5149";50;4;67;29;1338895;1343446;4551
"5249";50;4;79;30;1345965;1350078;4113
"5325";50;2;93;31;1353150;1357656;4506
"5426";50;2;65;32;1361197;1365089;3892
"5547";50;2;17;33;1368806;1373047;4241
"5727";50;2;57;34;1378190;1381081;2891
"5822";50;2;5;35;1384646;1389480;4834
"6046";50;4;3;36;1398404;1402121;3717
"6223";50;4;27;37;1409262;1413771;4509
"6423";50;2;21;38;1419492;1425252;5760
"6625";50;4;75;39;1433960;1442928;8968
"6749";50;2;73;40;1445413;1449986;4573
"6848";50;4;87;41;1453613;1457928;4315
"6949";50;2;45;42;1460569;1464636;4067
"7025";50;4;63;43;1467139;1471686;4547
"7127";50;2;41;44;1473862;1477798;3936
"7223";50;2;29;45;1483354;1488352;4998
"7425";50;2;69;46;1498736;1503443;4707
"7549";50;2;49;47;1506187;1509216;3029
"762";50;2;89;48;1512388;1515776;3388
"7747";50;4;31;49;1518649;1525076;6427
"7947";50;2;13;50;1530959;1535010;4051
"8148";50;1;64;51;1542425;1546243;3818
"8248";50;1;80;52;1549768;1554441;4673
"8324";50;1;44;53;1557659;1561291;3632
"8448";50;1;68;54;1564217;1568581;4364
"8529";50;3;70;55;1572442;1578805;6363
"8623";50;1;12;56;1581816;1587022;5206
"8823";50;3;6;57;1596341;1601006;4665
"9023";50;1;32;58;1606267;1610791;4524
"9247";50;3;22;59;1616570;1622464;5894
"9449";50;1;60;60;1628058;1630881;2823
"9549";50;3;90;61;1633660;1637888;4228
"9629";50;3;66;62;1640931;1645585;4654
"9746";50;3;14;63;1649156;1655851;6695
"9948";50;1;76;64;1661992;1666243;4251
"10024";50;1;84;65;1669053;1673654;4601
"10152";50;1;56;66;1676987;1681162;4175
"10227";50;3;34;67;1683695;1689095;5400
"10449";50;3;82;68;1696947;1702303;5356
"10529";50;3;94;69;1707234;1711360;4126
"10625";50;1;28;70;1715448;1720177;4729
"10830";50;1;92;71;1727068;1732008;4940
"10946";50;1;16;72;1734736;1738576;3840
"11170";50;3;10;73;1746296;1752376;6080
"11328";50;1;96;74;1759965;1763961;3996
"11448";50;3;58;75;1767290;1773192;5902
"11526";50;3;42;76;1776280;1780867;4587
"11649";50;3;50;77;1783420;1788883;5463
"11749";50;3;74;78;1791647;1797383;5736
"11825";50;3;62;79;1800181;1804940;4759
"11949";50;3;98;80;1807377;1812332;4955
"12049";50;3;54;81;1814694;1820165;5471
"12171";50;1;100;82;1823309;1827574;4265
"12251";50;1;52;83;1829862;1833917;4055
"12332";50;3;86;84;1837428;1843006;5578
"12425";50;3;38;85;1845539;1850473;4934
"12630";50;1;88;86;1856540;1860648;4108
"12724";50;3;30;87;1863219;1869408;6189
"12923";50;3;2;88;1874767;1880380;5613
"13129";50;1;72;89;1885705;1890738;5033
"13231";50;3;46;90;1893076;1900662;7586
"13324";50;1;4;91;1902918;1906679;3761
"13546";50;1;8;92;1914760;1918337;3577
"13747";50;1;36;93;1923829;1929708;5879
"13949";50;1;48;94;1934958;1938978;4020
"14029";50;3;78;95;1941332;1947172;5840
"14127";50;3;26;96;1949864;1954894;5030
"14347";50;3;18;97;1960279;1965343;5064
"14547";50;1;40;98;1970551;1974376;3825
"14747";50;1;20;99;1979993;1984528;4535
"14910";50;1;24;100;1990333;1994067;3734
"9149";51;1;63;1;2467572;2472102;4530
"10153";51;1;79;2;2481277;2485593;4316
"11171";51;1;43;3;2490860;2494759;3899
"12172";51;1;67;4;2497604;2502300;4696
"14106";51;3;69;6;2614334;2620404;6070
"1525";51;1;11;7;2623033;2628121;5088
"1726";51;3;5;8;2635169;2641287;6118
"1925";51;1;31;9;2649656;2655157;5501
"2126";51;3;21;10;2664461;2670745;6284
"2326";51;1;59;11;2677948;2683194;5246
"2449";51;3;89;12;2688944;2694869;5925
"2548";51;3;65;13;2699126;2705369;6243
"2626";51;3;13;14;2710928;2715918;4990
"2827";51;1;75;15;2722613;2728176;5563
"2948";51;1;83;16;2733286;2736934;3648
"3026";51;1;55;17;2742159;2747168;5009
"3125";51;3;33;18;2750198;2756634;6436
"3349";51;3;81;19;2765940;2771291;5351
"3448";51;3;93;20;2775040;2780274;5234
"3526";51;1;27;21;2782944;2787199;4255
"3749";51;1;91;22;2793027;2797741;4714
"3825";51;1;15;23;2801464;2805773;4309
"4026";51;3;9;24;2813077;2817856;4779
"4248";51;1;95;25;2824352;2829081;4729
"4328";51;3;57;26;2832769;2838698;5929
"4447";51;3;41;27;2841614;2846889;5275
"4527";51;3;49;28;2850590;2856438;5848
"4648";51;3;73;29;2860125;2865747;5622
"4749";51;3;61;30;2870763;2876304;5541
"4828";51;3;97;31;2879264;2885021;5757
"4947";51;3;53;32;2888462;2893554;5092
"5049";51;1;99;33;2897764;2902537;4773
"5150";51;1;51;34;2905710;2911153;5443
"5250";51;3;85;35;2916096;2921645;5549
"5326";51;3;37;36;2924009;2929303;5294
"5548";51;1;87;37;2935976;2939435;3459
"5624";51;3;29;38;2941873;2948535;6662
"5823";51;3;1;39;2954673;2960314;5641
"6047";51;1;71;40;2967127;2971518;4391
"6127";51;3;45;41;2975102;2979634;4532
"6224";51;1;3;42;2981879;2986124;4245
"6424";51;1;7;43;2995778;2999709;3931
"6626";51;1;35;44;3006599;3010800;4201
"6849";51;1;47;45;3016491;3020708;4217
"6950";51;3;77;46;3023708;3029086;5378
"7026";51;3;25;47;3032348;3037674;5326
"7224";51;3;17;48;3045072;3050423;5351
"7426";51;1;39;49;3058554;3062773;4219
"763";51;1;19;50;3068670;3073025;4355
"782";51;1;23;51;3080934;3084797;3863
"8047";51;4;98;52;3092726;3097155;4429
"8149";51;2;84;53;3146050;3150646;4596
"8249";51;4;82;54;3153472;3158271;4799
"8325";51;4;10;55;3162923;3168463;5540
"8530";51;2;92;56;3177895;3182650;4755
"8624";51;2;36;57;3184822;3188635;3813
"8824";51;4;38;58;3196660;3200595;3935
"9024";51;2;8;59;3209046;3213244;4198
"9248";51;4;54;60;3219720;3224253;4533
"9327";51;2;20;61;3226879;3230852;3973
"9550";51;2;48;62;3238465;3242785;4320
"9630";51;2;56;63;3245051;3248385;3334
"9747";51;2;44;64;3251137;3255343;4206
"9824";51;2;24;65;3259187;3262909;3722
"10025";51;2;40;66;3267962;3271042;3080
"10228";51;4;2;67;3277646;3282050;4404
"10450";51;2;72;68;3290243;3295933;5690
"10530";51;2;100;69;3302009;3305849;3840
"10626";51;2;16;70;3311764;3316041;4277
"10831";51;2;52;71;3322730;3327082;4352
"10947";51;4;62;72;3331283;3335564;4281
"11027";51;4;78;73;3338212;3343031;4819
"11172";51;2;96;74;3346039;3349509;3470
"11248";51;2;60;75;3354398;3357214;2816
"11329";51;2;12;76;3361756;3365372;3616
"11527";51;4;26;77;3372673;3377023;4350
"11750";51;4;86;78;3384193;3389055;4862
"11826";51;4;34;79;3393860;3398489;4629
"12050";51;2;68;80;3409518;3413529;4011
"12173";51;2;80;81;3415933;3420179;4246
"12252";51;4;94;82;3424537;3429187;4650
"12333";51;4;66;83;3432584;3437345;4761
"12426";51;4;18;84;3440021;3443876;3855
"12631";51;4;58;85;3449489;3453678;4189
"12725";51;4;6;86;3456815;3461325;4510
"12924";51;2;4;87;3466725;3470010;3285
"13130";51;2;28;88;3476286;3480651;4365
"13325";51;4;22;89;3489368;3493406;4038
"13547";51;2;76;90;3501843;3505167;3324
"13627";51;4;74;91;3507428;3512542;5114
"13748";51;2;88;92;3515385;3519317;3932
"13846";51;4;46;93;3523252;3527742;4490
"13950";51;2;64;94;3530890;3534089;3199
"14030";51;4;42;95;3539832;3544008;4176
"14128";51;4;30;96;3547070;3551033;3963
"14348";51;4;70;97;3558903;3563557;4654
"14427";51;4;50;98;3568147;3572907;4760
"14548";51;4;90;99;3578182;3582773;4591
"14611";51;2;32;100;3585266;3588940;3674
"14811";51;4;14;101;3594385;3598910;4525
"9150";52;4;97;1;4837230;4842114;4884
"10154";52;2;83;2;4845830;4849439;3609
"11173";52;4;81;3;4854242;4858835;4593
"12174";52;4;9;4;4861230;4867897;6667
"14107";52;2;91;5;4873357;4877255;3898
"1526";52;2;35;6;4880794;4884772;3978
"1727";52;4;37;7;4890623;4900398;9775
"1926";52;2;7;8;4905283;4910862;5579
"2127";52;4;53;9;4915806;4919420;3614
"2249";52;2;19;10;4923574;4928608;5034
"2450";52;2;47;11;4935819;4939448;3629
"2549";52;2;55;12;4945212;4949394;4182
"2627";52;2;43;13;4952807;4957602;4795
"2750";52;2;23;14;4961117;4964868;3751
"2949";52;2;39;15;4970002;4974018;4016
"3126";52;4;1;16;4978926;4987780;8854
"3350";52;2;71;17;4993219;4997217;3998
"3449";52;2;99;18;5000422;5004884;4462
"3527";52;2;15;19;5010292;5015365;5073
"3750";52;2;51;20;5020569;5025091;4522
"3826";52;4;61;21;5027099;5035199;8100
"3950";52;4;77;22;5037400;5041503;4103
"4027";52;2;95;23;5043684;5047608;3924
"4150";52;2;59;24;5050160;5052616;2456
"4249";52;2;11;25;5054981;5058448;3467
"4448";52;4;25;26;5065375;5071698;6323
"4649";52;4;85;27;5076959;5085867;8908
"4750";52;4;33;28;5088127;5091755;3628
"4948";52;2;67;29;5096370;5101883;5513
"5050";52;2;79;30;5139847;5143846;3999
"5151";52;4;93;31;5146276;5152336;6060
"5251";52;4;65;32;5154893;5159112;4219
"5327";52;4;17;33;5161364;5167728;6364
"5549";52;4;57;34;5172689;5178080;5391
"5625";52;4;5;35;5181271;5187929;6658
"5824";52;2;3;36;5196771;5200793;4022
"6048";52;2;27;37;5206077;5210099;4022
"6225";52;4;21;38;5216442;5221401;4959
"6425";52;2;75;39;5226263;5231244;4981
"6548";52;4;73;40;5233577;5238109;4532
"6627";52;2;87;41;5240407;5242892;2485
"6750";52;4;45;42;5245515;5249058;3543
"6850";52;2;63;43;5251625;5254692;3067
"6951";52;4;41;44;5257490;5261216;3726
"7027";52;4;29;45;5263447;5268049;4602
"7225";52;4;69;46;5272717;5278349;5632
"7347";52;4;49;47;5281607;5285882;4275
"7427";52;4;89;48;5289915;5294761;4846
"7550";52;2;31;49;5296937;5300928;3991
"7748";52;4;13;50;5305449;5310056;4607
"7948";52;3;64;51;5314899;5323881;8982
"8048";52;3;80;52;5326571;5333088;6517
"8150";52;3;44;53;5338970;5344622;5652
"8250";52;3;68;54;5347254;5354079;6825
"8326";52;1;70;55;5356335;5360329;3994
"8449";52;3;12;56;5364680;5370525;5845
"8625";52;1;6;57;5377590;5381262;3672
"8825";52;3;32;58;5386718;5393228;6510
"9025";52;1;22;59;5398006;5401794;3788
"9249";52;3;60;60;5406872;5410952;4080
"9328";52;1;90;61;5414948;5418710;3762
"9450";52;1;66;62;5422456;5426243;3787
"9551";52;1;14;63;5428881;5431893;3012
"9748";52;3;76;64;5437752;5442866;5114
"9825";52;3;84;65;5445480;5451109;5629
"9949";52;3;56;66;5454197;5458339;4142
"10026";52;1;34;67;5460822;5466035;5213
"10229";52;1;82;68;5471794;5474564;2770
"10345";52;1;94;69;5476854;5482191;5337
"10451";52;3;28;70;5485022;5491141;6119
"10627";52;3;92;71;5495952;5500932;4980
"10745";52;3;16;72;5503558;5508622;5064
"10948";52;1;10;73;5518836;5524732;5896
"11174";52;3;96;74;5530160;5536440;6280
"11249";52;1;58;75;5540350;5543397;3047
"11330";52;1;42;76;5545937;5550847;4910
"11449";52;1;50;77;5555875;5561797;5922
"11528";52;1;74;78;5564125;5568554;4429
"11650";52;1;62;79;5570935;5574188;3253
"11751";52;1;98;80;5577297;5579904;2607
"11827";52;1;54;81;5583961;5589554;5593
"11950";52;3;100;82;5592933;5597116;4183
"12051";52;3;52;83;5639380;5645792;6412
"12175";52;1;86;84;5647982;5651521;3539
"12253";52;1;38;85;5656137;5661161;5024
"12427";52;3;88;86;5765589;5772265;6676
"12546";52;1;30;87;5776414;5780281;3867
"12726";52;1;2;88;5785092;5789239;4147
"12925";52;3;72;89;5795173;5801555;6382
"13046";52;1;46;90;5803785;5808439;4654
"13131";52;3;4;91;5813012;5817105;4093
"13326";52;3;8;92;5822472;5828846;6374
"13548";52;3;36;93;5833970;5840371;6401
"13749";52;3;48;94;5847905;5853046;5141
"13847";52;1;78;95;5856016;5859804;3788
"13951";52;1;26;96;5862631;5867045;4414
"14129";52;1;18;97;5873093;5876445;3352
"14349";52;3;40;98;5881876;5886661;4785
"14549";52;3;20;99;5891469;5896178;4709
"14748";52;3;24;100;5901547;5906050;4503
"9151";53;3;63;1;1526789;1531517;4728
"10155";53;3;79;2;1534567;1540213;5646
"11175";53;3;43;3;1543324;1549146;5822
"12176";53;3;67;4;1551800;1559387;7587
"13132";53;1;69;5;1561976;1567879;5903
"14108";53;3;11;6;1570127;1576478;6351
"1625";53;1;5;7;1582736;1588345;5609
"1825";53;3;31;8;1594551;1600032;5481
"2025";53;1;21;9;1605782;1610722;4940
"2250";53;3;59;10;1616507;1622135;5628
"2327";53;1;89;11;1624719;1629323;4604
"2451";53;1;65;12;1631664;1637268;5604
"2550";53;1;13;13;1640607;1645668;5061
"2751";53;3;75;14;1651254;1656617;5363
"2828";53;3;83;15;1658794;1663309;4515
"2950";53;3;55;16;1665887;1670566;4679
"3027";53;1;33;17;1672854;1675883;3029
"3226";53;1;81;18;1680957;1685516;4559
"3351";53;1;93;19;1687698;1694141;6443
"3450";53;3;27;20;1697146;1702949;5803
"3627";53;3;91;21;1707882;1713315;5433
"3751";53;3;15;22;1715635;1720682;5047
"3951";53;1;9;23;1726313;1730481;4168
"4151";53;3;95;24;1737410;1742130;4720
"4250";53;1;57;25;1744704;1750431;5727
"4329";53;1;41;26;1754205;1758547;4342
"4449";53;1;49;27;1760782;1765505;4723
"4528";53;1;73;28;1768606;1772589;3983
"4650";53;1;61;29;1775236;1780672;5436
"4751";53;1;97;30;1783064;1788896;5832
"4829";53;1;53;31;1791047;1794654;3607
"4949";53;3;99;32;1797277;1801879;4602
"5051";53;3;51;33;1805112;1808554;3442
"5152";53;1;85;34;1811527;1816437;4910
"5252";53;1;37;35;1818909;1823120;4211
"5427";53;3;87;36;1828349;1831960;3611
"5550";53;1;29;37;1834400;1839419;5019
"5728";53;1;1;38;1846345;1853002;6657
"5927";53;3;71;39;1858888;1863352;4464
"6049";53;1;45;40;1866029;1870977;4948
"6128";53;3;3;41;1874852;1880380;5528
"6326";53;3;7;42;1885689;1893518;7829
"6549";53;3;35;43;1901535;1906758;5223
"6751";53;3;47;44;1912251;1918278;6027
"6851";53;1;77;45;1920852;1926391;5539
"6952";53;1;25;46;1928734;1932891;4157
"7128";53;1;17;47;1938099;1941914;3815
"7348";53;3;39;48;1949248;1955699;6451
"7551";53;3;19;49;2089933;2095013;5080
"7749";53;3;23;50;2100787;2105471;4684
"7949";53;2;98;51;2110502;2114671;4169
"8049";53;4;84;52;2117446;2123162;5716
"8151";53;2;82;53;2126045;2128803;2758
"8251";53;2;10;54;2131680;2136392;4712
"8450";53;4;92;55;2143609;2150503;6894
"8531";53;4;36;56;2158842;2164611;5769
"8726";53;2;38;57;2171902;2174363;2461
"8926";53;4;8;58;2180910;2186402;5492
"9152";53;2;54;59;2195986;2198742;2756
"9250";53;4;20;60;2202114;2205959;3845
"9451";53;4;48;61;2212704;2217842;5138
"9552";53;4;56;62;2224240;2230317;6077
"9631";53;4;44;63;2233599;2237458;3859
"9749";53;4;24;64;2239967;2245078;5111
"9950";53;4;40;65;2250329;2253299;2970
"10156";53;2;2;66;2258802;2262649;3847
"10346";53;4;72;67;2270649;2276598;5949
"10452";53;4;100;68;2416385;2419627;3242
"10531";53;4;16;69;2422572;2426051;3479
"10746";53;4;52;70;2431577;2436201;4624
"10832";53;2;62;71;2438614;2442018;3404
"10949";53;2;78;72;2445001;2448342;3341
"11028";53;4;96;73;2450643;2456367;5724
"11176";53;4;60;74;2460141;2464100;3959
"11250";53;4;12;75;2467392;2472783;5391
"11450";53;2;26;76;2479470;2483066;3596
"11651";53;2;86;77;2518766;2521515;2749
"11752";53;2;34;78;2524111;2527081;2970
"11951";53;4;68;79;2533601;2537571;3970
"12052";53;4;80;80;2542622;2546181;3559
"12177";53;2;94;81;2548638;2552455;3817
"12254";53;2;66;82;2555030;2558880;3850
"12334";53;2;18;83;2561524;2565493;3969
"12547";53;2;58;84;2572856;2576110;3254
"12632";53;2;6;85;2578576;2581413;2837
"12827";53;4;4;86;2588440;2591350;2910
"13047";53;4;28;87;2597734;2603304;5570
"13232";53;2;22;88;2608916;2611578;2662
"13427";53;4;76;89;2616753;2622281;5528
"13549";53;2;74;90;2625472;2627952;2480
"13628";53;4;88;91;2630841;2635111;4270
"13750";53;2;46;92;2637453;2641490;4037
"13848";53;4;64;93;2644100;2649402;5302
"13952";53;2;42;94;2651826;2654476;2650
"14031";53;2;30;95;2656641;2660818;4177
"14230";53;2;70;96;2666370;2670184;3814
"14350";53;2;50;97;2672583;2675768;3185
"14428";53;2;90;98;2678116;2681084;2968
"14550";53;4;32;99;2683427;2686809;3382
"14749";53;2;14;100;2691807;2695492;3685
"9153";54;2;97;1;3390965;3395985;5020
"10157";54;4;83;2;3398436;3403152;4716
"11177";54;2;81;3;3405714;3409777;4063
"12178";54;2;9;4;3412119;3415977;3858
"14109";54;4;91;5;3421151;3425251;4100
"1527";54;4;35;6;3429341;3434075;4734
"1728";54;2;37;7;3439603;3443746;4143
"1927";54;4;7;8;3448495;3452491;3996
"2128";54;2;53;9;3457957;3462028;4071
"2251";54;4;19;10;3464365;3468574;4209
"2452";54;4;47;11;3473456;3478508;5052
"2551";54;4;55;12;3481346;3486029;4683
"2628";54;4;43;13;3488331;3493694;5363
"2752";54;4;23;14;3495945;3500702;4757
"2951";54;4;39;15;3505678;3510055;4377
"3127";54;2;1;16;3515075;3519797;4722
"3352";54;4;71;17;3525120;3529955;4835
"3451";54;4;99;18;3532313;3536297;3984
"3528";54;4;15;19;3538760;3542622;3862
"3752";54;4;51;20;3548549;3553721;5172
"3827";54;2;61;21;3556165;3559067;2902
"3952";54;2;77;22;3561545;3564671;3126
"4028";54;4;95;23;3569063;3573636;4573
"4152";54;4;59;24;3576119;3580037;3918
"4251";54;4;11;25;3582497;3586332;3835
"4450";54;2;25;26;3591844;3594828;2984
"4651";54;2;85;27;3599948;3603670;3722
"4752";54;2;33;28;3606173;3609694;3521
"4950";54;4;67;29;3614755;3618977;4222
"5052";54;4;79;30;3622067;3626160;4093
"5153";54;2;93;31;3629055;3633094;4039
"5253";54;2;65;32;3636020;3639303;3283
"5328";54;2;17;33;3694575;3698180;3605
"5551";54;2;57;34;3706168;3708797;2629
"5626";54;2;5;35;3789397;3792539;3142
"5825";54;4;3;36;3798729;3802304;3575
"6050";54;4;27;37;3807441;3811354;3913
"6226";54;2;21;38;3815988;3821020;5032
"6426";54;4;75;39;3827159;3834212;7053
"6550";54;2;73;40;3836762;3841053;4291
"6628";54;4;87;41;3843785;3848094;4309
"6752";54;2;45;42;3851425;3853943;2518
"6852";54;4;63;43;3856329;3859591;3262
"6953";54;2;41;44;3862638;3865619;2981
"7028";54;2;29;45;3868059;3871385;3326
"7226";54;2;69;46;3876448;3879651;3203
"7349";54;2;49;47;3882522;3885529;3007
"7428";54;2;89;48;4029551;4032342;2791
"7552";54;4;31;49;4034860;4038965;4105
"7750";54;2;13;50;4043332;4046632;3300
"7950";54;1;64;51;4056958;4061298;4340
"8050";54;1;80;52;4063693;4067298;3605
"8152";54;1;44;53;4070130;4073698;3568
"8252";54;1;68;54;4076073;4080464;4391
"8327";54;3;70;55;4082927;4090130;7203
"8451";54;1;12;56;4092688;4098030;5342
"8626";54;3;6;57;4102880;4107171;4291
"8826";54;1;32;58;4112250;4116104;3854
"9026";54;3;22;59;4120841;4125495;4654
"9251";54;1;60;60;4130459;4134812;4353
"9329";54;3;90;61;4137510;4142328;4818
"9452";54;3;66;62;4145051;4149445;4394
"9553";54;3;14;63;4151961;4156286;4325
"9750";54;1;76;64;4161577;4165086;3509
"9826";54;1;84;65;4167560;4171161;3601
"9951";54;1;56;66;4173831;4176872;3041
"10027";54;3;34;67;4179526;4183111;3585
"10230";54;3;82;68;4189141;4196243;7102
"10347";54;3;94;69;4198778;4201840;3062
"10453";54;1;28;70;4204452;4207416;2964
"10628";54;1;92;71;4212928;4217106;4178
"10747";54;1;16;72;4219485;4223085;3600
"10950";54;3;10;73;4258981;4263382;4401
"11178";54;1;96;74;4268364;4271332;2968
"11251";54;3;58;75;4274246;4278182;3936
"11331";54;3;42;76;4282128;4285256;3128
"11451";54;3;50;77;4288157;4291671;3514
"11529";54;3;74;78;4294526;4298723;4197
"11652";54;3;62;79;4304091;4308472;4381
"11753";54;3;98;80;4312329;4315814;3485
"11828";54;3;54;81;4318309;4321813;3504
"11952";54;1;100;82;4324705;4328505;3800
"12053";54;1;52;83;4331447;4335417;3970
"12179";54;3;86;84;4338209;4343946;5737
"12255";54;3;38;85;4346353;4350279;3926
"12428";54;1;88;86;4356029;4361470;5441
"12548";54;3;30;87;4364463;4369188;4725
"12727";54;3;2;88;4374415;4379660;5245
"12926";54;1;72;89;4386940;4392602;5662
"13048";54;3;46;90;4395670;4401318;5648
"13133";54;1;4;91;4404569;4408351;3782
"13327";54;1;8;92;4414412;4419393;4981
"13550";54;1;36;93;4424722;4428693;3971
"13751";54;1;48;94;4434551;4438834;4283
"13849";54;3;78;95;4441573;4446250;4677
"13953";54;3;26;96;4449190;4454484;5294
"14130";54;3;18;97;4459581;4463715;4134
"14351";54;1;40;98;4469020;4473515;4495
"14551";54;1;20;99;4478447;4481449;3002
"14750";54;1;24;100;4486785;4491207;4422
"9154";55;1;63;1;6091605;6095956;4351
"10158";55;1;79;2;6098489;6103300;4811
"11179";55;1;43;3;6106608;6112444;5836
"12180";55;1;67;4;6115002;6121144;6142
"13134";55;3;69;5;6123431;6133510;10079
"14131";55;1;11;6;6135697;6140110;4413
"1626";55;3;5;7;6146909;6153451;6542
"1826";55;1;31;8;6160177;6165416;5239
"2026";55;3;21;9;6170684;6177600;6916
"2252";55;1;59;10;6183753;6187121;3368
"2328";55;3;89;11;6189744;6196050;6306
"2453";55;3;65;12;6198307;6208474;10167
"2552";55;3;13;13;6211283;6216939;5656
"2753";55;1;75;14;6223232;6230044;6812
"2829";55;1;83;15;6233106;6236806;3700
"2952";55;1;55;16;6239285;6243764;4479
"3028";55;3;33;17;6246663;6253047;6384
"3227";55;3;81;18;6258747;6265022;6275
"3353";55;3;93;19;6267841;6274663;6822
"3452";55;1;27;20;6277410;6283371;5961
"3628";55;1;91;21;6288683;6295346;6663
"3753";55;1;15;22;6297609;6302062;4453
"3953";55;3;9;23;6307223;6311229;4006
"4153";55;1;95;24;6316177;6320320;4143
"4252";55;3;57;25;6323038;6329067;6029
"4330";55;3;41;26;6331741;6336444;4703
"4451";55;3;49;27;6338731;6344739;6008
"4529";55;3;73;28;6347312;6353308;5996
"4652";55;3;61;29;6355553;6361493;5940
"4753";55;3;97;30;6363710;6370543;6833
"4830";55;3;53;31;6373284;6379485;6201
"4951";55;1;99;32;6381957;6385868;3911
"5053";55;1;51;33;6388122;6392067;3945
"5154";55;3;85;34;6395129;6402015;6886
"5254";55;3;37;35;6404494;6410308;5814
"5428";55;1;87;36;6415632;6418724;3092
"5552";55;3;29;37;6421444;6427632;6188
"5729";55;3;1;38;6432580;6437799;5219
"5928";55;1;71;39;6444231;6448065;3834
"6051";55;3;45;40;6450323;6454427;4104
"6129";55;1;3;41;6456912;6461931;5019
"6327";55;1;7;42;6467384;6471406;4022
"6551";55;1;35;43;6478227;6482948;4721
"6753";55;1;47;44;6491444;6495497;4053
"6853";55;3;77;45;6502647;6507355;4708
"6954";55;3;25;46;6510084;6517554;7470
"7129";55;3;17;47;6522939;6528762;5823
"7350";55;1;39;48;6533988;6537412;3424
"7553";55;1;19;49;6543472;6548370;4898
"7751";55;1;23;50;6584320;6612867;28547
"7951";55;4;98;51;6647689;6652833;5144
"8051";55;2;84;52;6655491;6661141;5650
"8153";55;4;82;53;6663305;6667499;4194
"8253";55;4;10;54;6669732;6675474;5742
"8452";55;2;92;55;6681319;6685355;4036
"8532";55;2;36;56;6689162;6693582;4420
"8727";55;4;38;57;6699355;6703620;4265
"8927";55;2;8;58;6709841;6712931;3090
"9155";55;4;54;59;6719226;6724373;5147
"9252";55;2;20;60;6728730;6732238;3508
"9453";55;2;48;61;6737162;6740838;3676
"9554";55;2;56;62;6743427;6746607;3180
"9632";55;2;44;63;6749146;6751679;2533
"9751";55;2;24;64;6754286;6757863;3577
"9952";55;2;40;65;6762918;6765529;2611
"10159";55;4;2;66;6770706;6774787;4081
"10348";55;2;72;67;6780870;6785978;5108
"10454";55;2;100;68;6788754;6792078;3324
"10532";55;2;16;69;6796043;6799778;3735
"10748";55;2;52;70;6806100;6810336;4236
"10833";55;4;62;71;6812676;6816552;3876
"10951";55;4;78;72;6863957;6870527;6570
"11029";55;2;96;73;6872999;6875644;2645
"11180";55;2;60;74;6878029;6880652;2623
"11252";55;2;12;75;6883152;6886491;3339
"11452";55;4;26;76;6893077;6897526;4449
"11653";55;4;86;77;6902882;6906367;3485
"11754";55;4;34;78;6909687;6915116;5429
"11953";55;2;68;79;6920035;6923413;3378
"12054";55;2;80;80;6925950;6929833;3883
"12181";55;4;94;81;6932066;6936233;4167
"12256";55;4;66;82;6938763;6944316;5553
"12335";55;4;18;83;6946638;6950841;4203
"12549";55;4;58;84;6955918;6959831;3913
"12633";55;4;6;85;6962244;6967215;4971
"12828";55;2;4;86;6972874;6975656;2782
"13049";55;2;28;87;6981827;6985881;4054
"13233";55;4;22;88;6991316;6995281;3965
"13428";55;2;76;89;6999942;7002610;2668
"13551";55;4;74;90;7004780;7010030;5250
"13629";55;2;88;91;7012479;7016172;3693
"13752";55;4;46;92;7018730;7022913;4183
"13850";55;2;64;93;7027733;7031396;3663
"13954";55;4;42;94;7033812;7037422;3610
"14032";55;4;30;95;7039675;7043404;3729
"14231";55;4;70;96;7049031;7054337;5306
"14352";55;4;50;97;7056418;7060542;4124
"14429";55;4;90;98;7062771;7068062;5291
"14552";55;2;32;99;7070456;7073527;3071
"14751";55;4;14;100;7079551;7086253;6702
"9156";56;4;97;1;713059;718194;5135
"10160";56;2;83;2;721550;727777;6227
"11181";56;4;81;3;731727;737643;5916
"12182";56;4;9;4;741889;746001;4112
"14132";56;2;91;5;751979;755392;3413
"1528";56;2;35;6;758002;762367;4365
"1729";56;4;37;7;767903;773792;5889
"1928";56;2;7;8;779972;784875;4903
"2129";56;4;53;9;790967;796708;5741
"2253";56;2;19;10;803115;806482;3367
"2454";56;2;47;11;812744;817998;5254
"2553";56;2;55;12;820725;825456;4731
"2629";56;2;43;13;828333;835531;7198
"2754";56;2;23;14;838615;841973;3358
"2953";56;2;39;15;847871;852764;4893
"3128";56;4;1;16;859455;864738;5283
"3354";56;2;71;17;871811;875405;3594
"3453";56;2;99;18;880553;884371;3818
"3529";56;2;15;19;887992;892287;4295
"3754";56;2;51;20;900055;903587;3532
"3828";56;4;61;21;906699;911986;5287
"3954";56;4;77;22;914991;920078;5087
"4029";56;2;95;23;923151;927195;4044
"4154";56;2;59;24;929995;933944;3949
"4253";56;2;11;25;936740;941602;4862
"4452";56;4;25;26;948273;953877;5604
"4653";56;4;85;27;959521;964485;4964
"4754";56;4;33;28;967230;971310;4080
"4952";56;2;67;29;976364;982776;6412
"5054";56;2;79;30;985949;988909;2960
"5155";56;4;93;31;992135;999000;6865
"5255";56;4;65;32;1001968;1008200;6232
"5329";56;4;17;33;1011275;1015433;4158
"5553";56;4;57;34;1021904;1028408;6504
"5627";56;4;5;35;1031975;1037640;5665
"5826";56;2;3;36;1042640;1047315;4675
"6052";56;2;27;37;1055501;1059898;4397
"6227";56;4;21;38;1065484;1073173;7689
"6427";56;2;75;39;1079949;1086681;6732
"6552";56;4;73;40;1090310;1094822;4512
"6629";56;2;87;41;1098030;1102163;4133
"6754";56;4;45;42;1105421;1111546;6125
"6854";56;2;63;43;1114973;1117888;2915
"6955";56;4;41;44;1120998;1124604;3606
"7029";56;4;29;45;1128250;1132771;4521
"7227";56;4;69;46;1139095;1146278;7183
"7351";56;4;49;47;1149628;1156020;6392
"7429";56;4;89;48;1160247;1166844;6597
"7554";56;2;31;49;1171595;1176436;4841
"7752";56;4;13;50;1183027;1188327;5300
"7952";56;3;64;51;1194858;1204735;9877
"8052";56;3;80;52;1208377;1217693;9316
"8154";56;3;44;53;1220536;1226192;5656
"8254";56;3;68;54;1229478;1235942;6464
"8328";56;1;70;55;1242362;1247725;5363
"8453";56;3;12;56;1251769;1258649;6880
"8627";56;1;6;57;1266120;1270016;3896
"8827";56;3;32;58;1275758;1282024;6266
"9027";56;1;22;59;1287726;1292124;4398
"9253";56;3;60;60;1298043;1304306;6263
"9330";56;1;90;61;1307786;1312556;4770
"9454";56;1;66;62;1318007;1324780;6773
"9555";56;1;14;63;1327587;1331214;3627
"9752";56;3;76;64;1336944;1347088;10144
"9827";56;3;84;65;1349646;1355579;5933
"9953";56;3;56;66;1358221;1365296;7075
"10028";56;1;34;67;1368995;1373787;4792
"10231";56;1;82;68;1379866;1385954;6088
"10349";56;1;94;69;1388942;1394011;5069
"10455";56;3;28;70;1396745;1404469;7724
"10629";56;3;92;71;1409752;1415911;6159
"10749";56;3;16;72;1419607;1426069;6462
"10952";56;1;10;73;1433617;1437018;3401
"11182";56;3;96;74;1443862;1448276;4414
"11253";56;1;58;75;1450716;1454326;3610
"11332";56;1;42;76;1457675;1461568;3893
"11453";56;1;50;77;1464528;1470609;6081
"11530";56;1;74;78;1473020;1479117;6097
"11654";56;1;62;79;1481729;1486458;4729
"11755";56;1;98;80;1490260;1493741;3481
"11829";56;1;54;81;1496633;1500316;3683
"11954";56;3;100;82;1503369;1508299;4930
"12055";56;3;52;83;1511268;1517690;6422
"12183";56;1;86;84;1521250;1525232;3982
"12257";56;1;38;85;1528012;1531990;3978
"12429";56;3;88;86;1537297;1544181;6884
"12550";56;1;30;87;1546699;1551623;4924
"12728";56;1;2;88;1556997;1560722;3725
"12927";56;3;72;89;1566414;1574480;8066
"13050";56;1;46;90;1577347;1582213;4866
"13135";56;3;4;91;1584760;1593413;8653
"13328";56;3;8;92;1599655;1605329;5674
"13552";56;3;36;93;1611135;1616154;5019
"13753";56;3;48;94;1621855;1627570;5715
"13851";56;1;78;95;1630748;1635011;4263
"13955";56;1;26;96;1638304;1642253;3949
"14133";56;1;18;97;1647240;1650869;3629
"14353";56;3;40;98;1657010;1663452;6442
"14553";56;3;20;99;1667775;1671994;4219
"14752";56;3;24;100;1677004;1682385;5381
"9157";57;3;63;1;2952132;2955375;3243
"10161";57;3;79;2;2958569;2961967;3398
"11183";57;3;43;3;2968746;2973183;4437
"12184";57;3;67;4;2975671;2979807;4136
"13136";57;1;69;5;2983157;2987474;4317
"14134";57;3;11;6;2990223;2994099;3876
"1627";57;1;5;7;3000313;3004473;4160
"1827";57;3;31;8;3011044;3015723;4679
"2027";57;1;21;9;3022611;3025923;3312
"2254";57;3;59;10;3032856;3037056;4200
"2329";57;1;89;11;3040343;3043464;3121
"2455";57;1;65;12;3049026;3053713;4687
"2554";57;1;13;13;3056915;3060038;3123
"2755";57;3;75;14;3064906;3069438;4532
"2830";57;3;83;15;3072852;3076437;3585
"2954";57;3;55;16;3080004;3083962;3958
"3029";57;1;33;17;3086623;3090429;3806
"3228";57;1;81;18;3096503;3100120;3617
"3355";57;1;93;19;3103844;3107253;3409
"3454";57;3;27;20;3110006;3114778;4772
"3629";57;3;91;21;3121171;3125128;3957
"3755";57;3;15;22;3128908;3133219;4311
"3955";57;1;9;23;3139468;3143294;3826
"4155";57;3;95;24;3148667;3152943;4276
"4254";57;1;57;25;3155749;3159451;3702
"4331";57;1;41;26;3162612;3166710;4098
"4453";57;1;49;27;3169559;3173226;3667
"4530";57;1;73;28;3175695;3178667;2972
"4654";57;1;61;29;3181158;3183834;2676
"4755";57;1;97;30;3186779;3191600;4821
"4831";57;1;53;31;3195886;3199067;3181
"4953";57;3;99;32;3205599;3210441;4842
"5055";57;3;51;33;3249149;3254056;4907
"5156";57;1;85;34;3256578;3259539;2961
"5256";57;1;37;35;3262180;3265098;2918
"5429";57;3;87;36;3270671;3274306;3635
"5554";57;1;29;37;3276793;3279522;2729
"5730";57;1;1;38;3284481;3288030;3549
"5929";57;3;71;39;3293832;3298105;4273
"6053";57;1;45;40;3300575;3303813;3238
"6130";57;3;3;41;3306040;3310779;4739
"6328";57;3;7;42;3316238;3320921;4683
"6553";57;3;35;43;3328119;3331570;3451
"6755";57;3;47;44;3336564;3340978;4414
"6855";57;1;77;45;3344360;3347361;3001
"6956";57;1;25;46;3349753;3353420;3667
"7130";57;1;17;47;3358537;3361661;3124
"7352";57;3;39;48;3366622;3370502;3880
"7555";57;3;19;49;3375269;3380560;5291
"7753";57;3;23;50;3386415;3390802;4387
"7953";57;2;98;51;3395653;3398885;3232
"8053";57;4;84;52;3401029;3404793;3764
"8155";57;2;82;53;3409419;3412717;3298
"8255";57;2;10;54;3414854;3418042;3188
"8454";57;4;92;55;3422994;3426692;3698
"8533";57;4;36;56;3428836;3432617;3781
"8728";57;2;38;57;3438297;3441466;3169
"8928";57;4;8;58;3446452;3450049;3597
"9158";57;2;54;59;3454978;3457549;2571
"9254";57;4;20;60;3459935;3463407;3472
"9455";57;4;48;61;3467577;3471474;3897
"9556";57;4;56;62;3473685;3477098;3413
"9633";57;4;44;63;3479435;3483415;3980
"9753";57;4;24;64;3485962;3490306;4344
"9954";57;4;40;65;3494895;3498290;3395
"10162";57;2;2;66;3502734;3505647;2913
"10350";57;4;72;67;3510675;3514514;3839
"10456";57;4;100;68;3516977;3520655;3678
"10533";57;4;16;69;3522775;3526922;4147
"10750";57;4;52;70;3532050;3535380;3330
"10834";57;2;62;71;3537909;3540121;2212
"10953";57;2;78;72;3542332;3545346;3014
"11030";57;4;96;73;3547441;3550238;2797
"11184";57;4;60;74;3552533;3555737;3204
"11254";57;4;12;75;3558884;3562562;3678
"11454";57;2;26;76;3569047;3572645;3598
"11655";57;2;86;77;3578370;3582136;3766
"11756";57;2;34;78;3585139;3588711;3572
"11955";57;4;68;79;3593708;3597936;4228
"12056";57;4;80;80;3601359;3605102;3743
"12185";57;2;94;81;3607605;3610302;2697
"12258";57;2;66;82;3614378;3618427;4049
"12336";57;2;18;83;3620727;3624252;3525
"12551";57;2;58;84;3629314;3634035;4721
"12634";57;2;6;85;3637429;3641251;3822
"12829";57;4;4;86;3645989;3649909;3920
"13051";57;4;28;87;3654579;3659392;4813
"13234";57;2;22;88;3664079;3668092;4013
"13429";57;4;76;89;3673474;3678225;4751
"13553";57;2;74;90;3680541;3684208;3667
"13630";57;4;88;91;3689445;3694416;4971
"13754";57;2;46;92;3696755;3700232;3477
"13852";57;4;64;93;3705001;3709357;4356
"13956";57;2;42;94;3711770;3715232;3462
"14033";57;2;30;95;3717912;3722282;4370
"14232";57;2;70;96;3728567;3732706;4139
"14354";57;2;50;97;3735291;3739556;4265
"14430";57;2;90;98;3742117;3746039;3922
"14554";57;4;32;99;3748167;3751931;3764
"14753";57;2;14;100;3757205;3761497;4292
"9159";58;2;97;1;1206815;1212500;5685
"10163";58;4;83;2;1216849;1220750;3901
"11185";58;2;81;3;1223227;1227850;4623
"12186";58;2;9;4;1231011;1235424;4413
"14135";58;4;91;5;1244314;1248815;4501
"1529";58;4;35;6;1252579;1257648;5069
"1730";58;2;37;7;1263796;1268173;4377
"1929";58;4;7;8;1274882;1278914;4032
"2130";58;2;53;9;1285986;1289781;3795
"2255";58;4;19;10;1293118;1297872;4754
"2456";58;4;47;11;1305625;1309588;3963
"2555";58;4;55;12;1312934;1317538;4604
"2630";58;4;43;13;1322565;1328463;5898
"2756";58;4;23;14;1331048;1335646;4598
"2955";58;4;39;15;1340831;1344312;3481
"3129";58;2;1;16;1352731;1356461;3730
"3356";58;4;71;17;1362428;1367103;4675
"3455";58;4;99;18;1369802;1373461;3659
"3530";58;4;15;19;1375795;1379444;3649
"3756";58;4;51;20;1386293;1391069;4776
"3829";58;2;61;21;1393451;1398477;5026
"3956";58;2;77;22;1401070;1404585;3515
"4030";58;4;95;23;1408498;1413593;5095
"4156";58;4;59;24;1416157;1419959;3802
"4255";58;4;11;25;1424529;1428534;4005
"4454";58;2;25;26;1435579;1440259;4680
"4655";58;2;85;27;1446786;1453375;6589
"4756";58;2;33;28;1457155;1460383;3228
"4954";58;4;67;29;1465571;1475008;9437
"5056";58;4;79;30;1479136;1483365;4229
"5157";58;2;93;31;1487899;1491832;3933
"5257";58;2;65;32;1494247;1497557;3310
"5330";58;2;17;33;1500315;1503157;2842
"5555";58;2;57;34;1508301;1511206;2905
"5628";58;2;5;35;1513519;1517023;3504
"5827";58;4;3;36;1522185;1526472;4287
"6054";58;4;27;37;1532151;1536814;4663
"6228";58;2;21;38;1541876;1545355;3479
"6428";58;4;75;39;1550541;1555996;5455
"6554";58;2;73;40;1559409;1562763;3354
"6630";58;4;87;41;1565989;1569229;3240
"6756";58;2;45;42;1571488;1576321;4833
"6856";58;4;63;43;1580039;1584179;4140
"6957";58;2;41;44;1586825;1589445;2620
"7030";58;2;29;45;1594524;1598478;3954
"7228";58;2;69;46;1606761;1610761;4000
"7353";58;2;49;47;1615043;1618386;3343
"7430";58;2;89;48;1621988;1624760;2772
"7556";58;4;31;49;1629263;1634994;5731
"7754";58;2;13;50;1777534;1782449;4915
"7954";58;1;64;51;1788361;1792491;4130
"8054";58;1;80;52;1796575;1800190;3615
"8156";58;1;44;53;1804052;1808015;3963
"8256";58;1;68;54;1812947;1816815;3868
"8329";58;3;70;55;1821763;1826998;5235
"8455";58;1;12;56;1829916;1834022;4106
"8628";58;3;6;57;1839795;1843363;3568
"8828";58;1;32;58;1849212;1852572;3360
"9028";58;3;22;59;1860684;1864413;3729
"9255";58;1;60;60;1870938;1873546;2608
"9331";58;3;90;61;1878335;1882154;3819
"9456";58;3;66;62;1884759;1889612;4853
"9557";58;3;14;63;1892539;1897245;4706
"9754";58;1;76;64;1902582;1906095;3513
"9828";58;1;84;65;1910564;1913953;3389
"9955";58;1;56;66;1917544;1920253;2709
"10029";58;3;34;67;1922730;1926794;4064
"10232";58;3;82;68;1935541;1939294;3753
"10351";58;3;94;69;2031794;2035582;3788
"10457";58;1;28;70;2039340;2044165;4825
"10630";58;1;92;71;2052129;2055914;3785
"10751";58;1;16;72;2059585;2065739;6154
"10954";58;3;10;73;2071816;2077655;5839
"11186";58;1;96;74;2083970;2088113;4143
"11255";58;3;58;75;2090830;2096230;5400
"11333";58;3;42;76;2100328;2106921;6593
"11455";58;3;50;77;2109517;2114787;5270
"11531";58;3;74;78;2119247;2124078;4831
"11656";58;3;62;79;2127565;2130778;3213
"11757";58;3;98;80;2134270;2138362;4092
"11830";58;3;54;81;2142940;2147203;4263
"11956";58;1;100;82;2149608;2153369;3761
"12057";58;1;52;83;2157906;2161161;3255
"12187";58;3;86;84;2166426;2170636;4210
"12259";58;3;38;85;2173806;2177794;3988
"12430";58;1;88;86;2183606;2187702;4096
"12552";58;3;30;87;2193143;2197393;4250
"12729";58;3;2;88;2203158;2208009;4851
"12928";58;1;72;89;2213094;2217509;4415
"13052";58;3;46;90;2219989;2224134;4145
"13137";58;1;4;91;2228982;2231175;2193
"13329";58;1;8;92;2237329;2240566;3237
"13554";58;1;36;93;2246846;2250008;3162
"13755";58;1;48;94;2257619;2260649;3030
"13853";58;3;78;95;2263525;2267990;4465
"13957";58;3;26;96;2270599;2277423;6824
"14136";58;3;18;97;2282144;2286615;4471
"14355";58;1;40;98;2292342;2295148;2806
"14555";58;1;20;99;2300992;2303856;2864
"14754";58;1;24;100;2308569;2312439;3870
"9160";59;1;63;1;3394247;3398845;4598
"10164";59;1;79;2;3401255;3405215;3960
"11187";59;1;43;3;3407672;3412512;4840
"12188";59;1;67;4;3415154;3420976;5822
"13138";59;3;69;5;3423667;3432328;8661
"14137";59;1;11;6;3434850;3438903;4053
"1628";59;3;5;7;3446541;3452610;6069
"1828";59;1;31;8;3462322;3469219;6897
"2028";59;3;21;9;3476835;3484409;7574
"2256";59;1;59;10;3490085;3495475;5390
"2330";59;3;89;11;3497972;3503284;5312
"2457";59;3;65;12;3505898;3512518;6620
"2556";59;3;13;13;3515132;3521591;6459
"2757";59;1;75;14;3528616;3538757;10141
"2831";59;1;83;15;3541347;3545024;3677
"2956";59;1;55;16;3547586;3552282;4696
"3030";59;3;33;17;3554760;3562940;8180
"3229";59;3;81;18;3569558;3576723;7165
"3357";59;3;93;19;3582956;3588880;5924
"3456";59;1;27;20;3591594;3596572;4978
"3630";59;1;91;21;3601852;3606305;4453
"3757";59;1;15;22;3608877;3612896;4019
"3957";59;3;9;23;3618829;3625113;6284
"4157";59;1;95;24;3630682;3635429;4747
"4256";59;3;57;25;3638354;3644645;6291
"4332";59;3;41;26;3647263;3653637;6374
"4455";59;3;49;27;3656264;3663703;7439
"4531";59;3;73;28;3666363;3672577;6214
"4656";59;3;61;29;3675076;3681277;6201
"4757";59;3;97;30;3683789;3691860;8071
"4832";59;3;53;31;3694657;3700543;5886
"4955";59;1;99;32;3703018;3706710;3692
"5057";59;1;51;33;3709185;3713996;4811
"5158";59;3;85;34;3716341;3724917;8576
"5258";59;3;37;35;3727434;3734300;6866
"5430";59;1;87;36;3740199;3744517;4318
"5556";59;3;29;37;3747381;3753025;5644
"5731";59;3;1;38;3758861;3764671;5810
"5930";59;1;71;39;3771931;3776249;4318
"6055";59;3;45;40;3778687;3782865;4178
"6131";59;1;3;41;3788747;3794023;5276
"6329";59;1;7;42;3803571;3808415;4844
"6555";59;1;35;43;3815987;3821822;5835
"6757";59;1;47;44;3828402;3832730;4328
"6857";59;3;77;45;3838641;3849638;10997
"6958";59;3;25;46;3852762;3860679;7917
"7131";59;3;17;47;3872546;3878543;5997
"7354";59;1;39;48;3993158;3997593;4435
"7557";59;1;19;49;4007580;4012313;4733
"7755";59;1;23;50;4024690;4029683;4993
"7955";59;4;98;51;4224492;4229468;4976
"8055";59;2;84;52;4238588;4245234;6646
"8157";59;4;82;53;4251551;4258010;6459
"8257";59;4;10;54;4260705;4266559;5854
"8456";59;2;92;55;4276295;4281124;4829
"8534";59;2;36;56;4283683;4289541;5858
"8729";59;4;38;57;4295240;4301757;6517
"8929";59;2;8;58;4307178;4312265;5087
"9161";59;4;54;59;4318673;4323556;4883
"9256";59;2;20;60;4325940;4330023;4083
"9457";59;2;48;61;4337506;4342598;5092
"9558";59;2;56;62;4345077;4349139;4062
"9634";59;2;44;63;4351910;4356480;4570
"9755";59;2;24;64;4361906;4366463;4557
"9956";59;2;40;65;4372880;4377233;4353
"10165";59;4;2;66;4382232;4387863;5631
"10352";59;2;72;67;4396266;4403437;7171
"10458";59;2;100;68;4405888;4411195;5307
"10534";59;2;16;69;4414900;4421028;6128
"10752";59;2;52;70;4426688;4431086;4398
"10835";59;4;62;71;4463768;4467601;3833
"10955";59;4;78;72;4470182;4475201;5019
"11031";59;2;96;73;4477462;4482292;4830
"11188";59;2;60;74;4484761;4489033;4272
"11256";59;2;12;75;4492333;4496692;4359
"11456";59;4;26;76;4503108;4508083;4975
"11657";59;4;86;77;4513958;4518941;4983
"11758";59;4;34;78;4521381;4526708;5327
"11957";59;2;68;79;4532357;4536732;4375
"12058";59;2;80;80;4539271;4544765;5494
"12189";59;4;94;81;4547448;4552440;4992
"12260";59;4;66;82;4555312;4560915;5603
"12337";59;4;18;83;4563682;4568231;4549
"12553";59;4;58;84;4573716;4578991;5275
"12635";59;4;6;85;4582458;4587897;5439
"12830";59;2;4;86;4594013;4597938;3925
"13053";59;2;28;87;4604473;4610646;6173
"13235";59;4;22;88;4617393;4622713;5320
"13430";59;2;76;89;4637361;4642828;5467
"13555";59;4;74;90;4647789;4653068;5279
"13631";59;2;88;91;4655555;4659461;3906
"13756";59;4;46;92;4662626;4667877;5251
"13854";59;2;64;93;4670383;4674811;4428
"13958";59;4;42;94;4678356;4682869;4513
"14034";59;4;30;95;4685275;4690027;4752
"14233";59;4;70;96;4699653;4705626;5973
"14356";59;4;50;97;4708136;4713544;5408
"14431";59;4;90;98;4716674;4722059;5385
"14556";59;2;32;99;4724586;4728326;3740
"14755";59;4;14;100;4737370;4742600;5230
"9162";60;4;97;1;3403020;3406753;3733
"10166";60;2;83;2;3409551;3411402;1851
"11189";60;4;81;3;3414152;3417294;3142
"12190";60;4;9;4;3420257;3423269;3012
"14138";60;2;91;5;3429461;3433280;3819
"1530";60;2;35;6;3437362;3441800;4438
"1731";60;4;37;7;3451669;3455876;4207
"1930";60;2;7;8;3461838;3466962;5124
"2131";60;4;53;9;3472455;3475947;3492
"2257";60;2;19;10;3576927;3580324;3397
"2458";60;2;47;11;3586227;3588972;2745
"2557";60;2;55;12;3591605;3594706;3101
"2631";60;2;43;13;3598708;3602549;3841
"2758";60;2;23;14;3606932;3609949;3017
"2957";60;2;39;15;3615706;3618813;3107
"3130";60;4;1;16;3624525;3631623;7098
"3358";60;2;71;17;3637528;3639854;2326
"3457";60;2;99;18;3643326;3646488;3162
"3531";60;2;15;19;3649722;3653168;3446
"3758";60;2;51;20;3659002;3663593;4591
"3830";60;4;61;21;3670517;3676786;6269
"3958";60;4;77;22;3682777;3690061;7284
"4031";60;2;95;23;3704566;3712610;8044
"4158";60;2;59;24;3714920;3718421;3501
"4257";60;2;11;25;3720768;3724437;3669
"4456";60;4;25;26;3729412;3735038;5626
"4657";60;4;85;27;3741087;3746111;5024
"4758";60;4;33;28;3749065;3753879;4814
"4956";60;2;67;29;3758812;3762291;3479
"5058";60;2;79;30;3765417;3768305;2888
"5159";60;4;93;31;3773005;3777905;4900
"5259";60;4;65;32;3781278;3786815;5537
"5331";60;4;17;33;3789595;3794273;4678
"5557";60;4;57;34;3799906;3804456;4550
"5629";60;4;5;35;3807298;3814171;6873
"5828";60;2;3;36;3819006;3823497;4491
"6056";60;2;27;37;3829000;3832189;3189
"6229";60;4;21;38;3837513;3845163;7650
"6429";60;2;75;39;3851368;3857870;6502
"6556";60;4;73;40;3864902;3870429;5527
"6631";60;2;87;41;3874616;3877832;3216
"6758";60;4;45;42;3881418;3884753;3335
"6858";60;2;63;43;3887669;3891212;3543
"6959";60;4;41;44;3895243;3899403;4160
"7031";60;4;29;45;3902834;3908511;5677
"7229";60;4;69;46;3916984;3923352;6368
"7355";60;4;49;47;3926426;3932527;6101
"7431";60;4;89;48;3935238;3939348;4110
"7558";60;2;31;49;4094614;4097904;3290
"7756";60;4;13;50;4103884;4107954;4070
"7956";60;3;64;51;4113075;4118170;5095
"8056";60;3;80;52;4122260;4126912;4652
"8158";60;3;44;53;4132233;4136211;3978
"8258";60;3;68;54;4144736;4149502;4766
"8330";60;1;70;55;4156066;4159885;3819
"8457";60;3;12;56;4211421;4215310;3889
"8629";60;1;6;57;4221009;4225071;4062
"8829";60;3;32;58;4231980;4237491;5511
"9029";60;1;22;59;4243737;4246601;2864
"9257";60;3;60;60;4256169;4262832;6663
"9332";60;1;90;61;4265522;4269357;3835
"9458";60;1;66;62;4273634;4278581;4947
"9559";60;1;14;63;4283019;4287539;4520
"9756";60;3;76;64;4293228;4301139;7911
"9829";60;3;84;65;4307145;4312213;5068
"9957";60;3;56;66;4317427;4321829;4402
"10030";60;1;34;67;4326117;4330229;4112
"10233";60;1;82;68;4336177;4340103;3926
"10353";60;1;94;69;4345889;4351478;5589
"10459";60;3;28;70;4354334;4360503;6169
"10631";60;3;92;71;4367574;4374444;6870
"10753";60;3;16;72;4381328;4388466;7138
"10956";60;1;10;73;4421602;4427892;6290
"11190";60;3;96;74;4433240;4437717;4477
"11257";60;1;58;75;4439944;4444542;4598
"11334";60;1;42;76;4514459;4521722;7263
"11457";60;1;50;77;4524595;4530939;6344
"11532";60;1;74;78;4533215;4536692;3477
"11658";60;1;62;79;4538827;4544588;5761
"11759";60;1;98;80;4546830;4551271;4441
"11831";60;1;54;81;4553541;4557696;4155
"11958";60;3;100;82;4560014;4564238;4224
"12059";60;3;52;83;4566541;4572734;6193
"12191";60;1;86;84;4575103;4578570;3467
"12261";60;1;38;85;4580935;4583870;2935
"12431";60;3;88;86;4588914;4593431;4517
"12554";60;1;30;87;4595806;4600793;4987
"12730";60;1;2;88;4605624;4609041;3417
"12929";60;3;72;89;4614497;4621825;7328
"13054";60;1;46;90;4624130;4628402;4272
"13139";60;3;4;91;4630690;4636218;5528
"13330";60;3;8;92;4641586;4647315;5729
"13556";60;3;36;93;4652331;4656795;4464
"13757";60;3;48;94;4663814;4670333;6519
"13855";60;1;78;95;4672907;4677984;5077
"13959";60;1;26;96;4680990;4685583;4593
"14139";60;1;18;97;4690806;4695790;4984
"14357";60;3;40;98;4701011;4705887;4876
"14557";60;3;20;99;4710569;4719456;8887
"14756";60;3;24;100;4724678;4729913;5235
"9163";61;3;63;1;2282124;2288912;6788
"10167";61;3;79;2;2292626;2298069;5443
"11191";61;3;43;3;2301302;2309494;8192
"12192";61;3;67;4;2313229;2322585;9356
"13140";61;1;69;5;2325554;2333160;7606
"14140";61;3;11;6;2335677;2344393;8716
"1629";61;1;5;7;2350911;2356559;5648
"1829";61;3;31;8;2362581;2371059;8478
"2029";61;1;21;9;2377174;2383474;6300
"2258";61;3;59;10;2391290;2400307;9017
"2331";61;1;89;11;2403121;2407724;4603
"2459";61;1;65;12;2410738;2415815;5077
"2558";61;1;13;13;2418625;2423298;4673
"2759";61;3;75;14;2430686;2440281;9595
"2832";61;3;83;15;2442817;2451814;8997
"2958";61;3;55;16;2456394;2464288;7894
"3031";61;1;33;17;2466519;2471396;4877
"3230";61;1;81;18;2477397;2483296;5899
"3359";61;1;93;19;2486820;2494396;7576
"3458";61;3;27;20;2496696;2503995;7299
"3631";61;3;91;21;2510596;2519903;9307
"3759";61;3;15;22;2523978;2529636;5658
"3959";61;1;9;23;2537054;2544402;7348
"4159";61;3;95;24;2550057;2556585;6528
"4258";61;1;57;25;2559227;2565026;5799
"4333";61;1;41;26;2568255;2572418;4163
"4457";61;1;49;27;2575923;2580743;4820
"4532";61;1;73;28;2583387;2588951;5564
"4658";61;1;61;29;2591219;2595767;4548
"4759";61;1;97;30;2600433;2611566;11133
"4833";61;1;53;31;2614049;2623307;9258
"4957";61;3;99;32;2626202;2633707;7505
"5059";61;3;51;33;2636188;2642624;6436
"5160";61;1;85;34;2649234;2654623;5389
"5260";61;1;37;35;2657025;2661489;4464
"5431";61;3;87;36;2675620;2687389;11769
"5558";61;1;29;37;2689676;2695597;5921
"5732";61;1;1;38;2701215;2706555;5340
"5931";61;3;71;39;2714026;2719854;5828
"6057";61;1;45;40;2722924;2732695;9771
"6132";61;3;3;41;2735131;2743120;7989
"6330";61;3;7;42;2750352;2755895;5543
"6557";61;3;35;43;2763578;2771736;8158
"6759";61;3;47;44;2778454;2784910;6456
"6859";61;1;77;45;2787614;2793910;6296
"6960";61;1;25;46;2796859;2801384;4525
"7132";61;1;17;47;2808469;2813417;4948
"7356";61;3;39;48;2819173;2825625;6452
"7559";61;3;19;49;2831926;2838583;6657
"7757";61;3;23;50;2844162;2854824;10662
"7957";61;2;98;51;2861002;2865691;4689
"8057";61;4;84;52;2868181;2873957;5776
"8159";61;2;82;53;2876696;2881507;4811
"8259";61;2;10;54;2884841;2889707;4866
"8458";61;4;92;55;2947047;2954196;7149
"8535";61;4;36;56;2956575;2961120;4545
"8730";61;2;38;57;2967868;2973095;5227
"8930";61;4;8;58;2987637;2995827;8190
"9164";61;2;54;59;3002464;3005727;3263
"9258";61;4;20;60;3008646;3013919;5273
"9459";61;4;48;61;3019354;3026018;6664
"9560";61;4;56;62;3029574;3036835;7261
"9635";61;4;44;63;3041819;3048067;6248
"9757";61;4;24;64;3050855;3058875;8020
"9958";61;4;40;65;3065053;3071450;6397
"10168";61;2;2;66;3077021;3082533;5512
"10354";61;4;72;67;3091061;3097749;6688
"10460";61;4;100;68;3128780;3132591;3811
"10535";61;4;16;69;3135163;3139699;4536
"10754";61;4;52;70;3145643;3150857;5214
"10836";61;2;62;71;3153199;3156174;2975
"10957";61;2;78;72;3158542;3163748;5206
"11032";61;4;96;73;3166089;3173115;7026
"11192";61;4;60;74;3175916;3179781;3865
"11258";61;4;12;75;3182267;3186881;4614
"11458";61;2;26;76;3194446;3200805;6359
"11659";61;2;86;77;3206964;3211097;4133
"11760";61;2;34;78;3213335;3219213;5878
"11959";61;4;68;79;3225029;3229738;4709
"12060";61;4;80;80;3232562;3240021;7459
"12193";61;2;94;81;3242260;3247345;5085
"12262";61;2;66;82;3249696;3254029;4333
"12338";61;2;18;83;3258302;3263253;4951
"12555";61;2;58;84;3269828;3276119;6291
"12636";61;2;6;85;3278866;3286095;7229
"12831";61;4;4;86;3291469;3297785;6316
"13055";61;4;28;87;3303171;3309993;6822
"13236";61;2;22;88;3316910;3319443;2533
"13431";61;4;76;89;3324945;3329384;4439
"13557";61;2;74;90;3331805;3335376;3571
"13632";61;4;88;91;3339265;3346350;7085
"13758";61;2;46;92;3349455;3354958;5503
"13856";61;4;64;93;3357495;3363324;5829
"13960";61;2;42;94;3366834;3370533;3699
"14035";61;2;30;95;3372701;3375849;3148
"14234";61;2;70;96;3382298;3388065;5767
"14358";61;2;50;97;3390368;3395090;4722
"14432";61;2;90;98;3397553;3401948;4395
"14558";61;4;32;99;3405108;3412973;7865
"14757";61;2;14;100;3418626;3424581;5955
"9165";62;2;97;1;774609;778383;3774
"10169";62;4;83;2;781589;784750;3161
"11193";62;2;81;3;787366;789950;2584
"12194";62;2;9;4;796139;798541;2402
"14141";62;4;91;5;803397;806866;3469
"1531";62;4;35;6;809860;813532;3672
"1732";62;2;37;7;819490;823182;3692
"1931";62;4;7;8;828175;831490;3315
"2132";62;2;53;9;837137;840740;3603
"2259";62;4;19;10;843959;847272;3313
"2460";62;4;47;11;853118;856105;2987
"2559";62;4;55;12;858635;861564;2929
"2632";62;4;43;13;864226;867713;3487
"2760";62;4;23;14;872507;875622;3115
"2959";62;4;39;15;880500;883630;3130
"3131";62;2;1;16;890359;893546;3187
"3360";62;4;71;17;899589;902521;2932
"3459";62;4;99;18;905631;909312;3681
"3532";62;4;15;19;912026;915112;3086
"3760";62;4;51;20;920127;923120;2993
"3831";62;2;61;21;925450;928003;2553
"3960";62;2;77;22;931902;934286;2384
"4032";62;4;95;23;937633;941978;4345
"4160";62;4;59;24;944513;947477;2964
"4259";62;4;11;25;951318;955619;4301
"4458";62;2;25;26;960906;965094;4188
"4659";62;2;85;27;970015;973152;3137
"4760";62;2;33;28;975871;978660;2789
"4958";62;4;67;29;988996;992909;3913
"5060";62;4;79;30;995400;999959;4559
"5161";62;2;93;31;1003378;1006225;2847
"5261";62;2;65;32;1009575;1013133;3558
"5332";62;2;17;33;1016591;1019384;2793
"5559";62;2;57;34;1025876;1028508;2632
"5630";62;2;5;35;1031508;1034782;3274
"5829";62;4;3;36;1040888;1044432;3544
"6058";62;4;27;37;1050959;1054199;3240
"6230";62;2;21;38;1058884;1061473;2589
"6430";62;4;75;39;1066790;1073531;6741
"6558";62;2;73;40;1078110;1081256;3146
"6632";62;4;87;41;1085523;1088222;2699
"6760";62;2;45;42;1091949;1094647;2698
"6860";62;4;63;43;1097422;1100297;2875
"6961";62;2;41;44;1102560;1105005;2445
"7032";62;2;29;45;1107597;1110922;3325
"7230";62;2;69;46;1115848;1118738;2890
"7357";62;2;49;47;1121693;1125129;3436
"7432";62;2;89;48;1158055;1160761;2706
"7560";62;4;31;49;1165822;1170069;4247
"7758";62;2;13;50;1175442;1177603;2161
"7958";62;1;64;51;1183271;1186844;3573
"8058";62;1;80;52;1190311;1193185;2874
"8160";62;1;44;53;1195682;1198468;2786
"8260";62;1;68;54;1201432;1205176;3744
"8331";62;3;70;55;1208128;1211993;3865
"8459";62;1;12;56;1215053;1219159;4106
"8630";62;3;6;57;1224539;1229542;5003
"8830";62;1;32;58;1237043;1239433;2390
"9030";62;3;22;59;1247243;1251142;3899
"9259";62;1;60;60;1257249;1260066;2817
"9333";62;3;90;61;1264359;1268574;4215
"9460";62;3;66;62;1272883;1277449;4566
"9561";62;3;14;63;1280093;1283674;3581
"9758";62;1;76;64;1289681;1292523;2842
"9830";62;1;84;65;1297623;1301415;3792
"9959";62;1;56;66;1304989;1307873;2884
"10031";62;3;34;67;1592201;1597781;5580
"10234";62;3;82;68;1602610;1606172;3562
"10355";62;3;94;69;1608664;1612364;3700
"10461";62;1;28;70;1616417;1619880;3463
"10632";62;1;92;71;1625089;1631180;6091
"10755";62;1;16;72;1633859;1637363;3504
"10958";62;3;10;73;1642300;1646379;4079
"11194";62;1;96;74;1651669;1654512;2843
"11259";62;3;58;75;1656883;1661220;4337
"11335";62;3;42;76;1664366;1669178;4812
"11459";62;3;50;77;1671473;1676228;4755
"11533";62;3;74;78;1678422;1681986;3564
"11660";62;3;62;79;1684732;1687869;3137
"11761";62;3;98;80;1690305;1693252;2947
"11832";62;3;54;81;1695593;1700344;4751
"11960";62;1;100;82;1702548;1706335;3787
"12061";62;1;52;83;1708831;1711952;3121
"12195";62;3;86;84;1714414;1719460;5046
"12263";62;3;38;85;1721742;1725084;3342
"12432";62;1;88;86;1730578;1733709;3131
"12556";62;3;30;87;1735996;1740001;4005
"12731";62;3;2;88;1744696;1748959;4263
"12930";62;1;72;89;1754603;1758492;3889
"13056";62;3;46;90;1760678;1765341;4663
"13141";62;1;4;91;1767716;1770916;3200
"13331";62;1;8;92;1776494;1779958;3464
"13558";62;1;36;93;1785253;1788857;3604
"13759";62;1;48;94;1793395;1796274;2879
"13857";62;3;78;95;1798532;1803382;4850
"13961";62;3;26;96;1806243;1810890;4647
"14142";62;3;18;97;1815870;1819740;3870
"14359";62;1;40;98;1825777;1829939;4162
"14559";62;1;20;99;1834925;1838072;3147
"14758";62;1;24;100;1843339;1846439;3100
"9166";63;1;63;1;1209829;1214316;4487
"10170";63;1;79;2;1217493;1221799;4306
"11195";63;1;43;3;1224333;1235122;10789
"12196";63;1;67;4;1238006;1242165;4159
"13142";63;3;69;5;1245263;1253340;8077
"14143";63;1;11;6;1256095;1260898;4803
"1630";63;3;5;7;1268317;1275931;7614
"1830";63;1;31;8;1283435;1290914;7479
"2030";63;3;21;9;1297019;1304958;7939
"2260";63;1;59;10;1311871;1316688;4817
"2332";63;3;89;11;1319462;1324029;4567
"2461";63;3;65;12;1329033;1336528;7495
"2560";63;3;13;13;1339111;1344016;4905
"2761";63;1;75;14;1349871;1356465;6594
"2833";63;1;83;15;1359112;1362034;2922
"2960";63;1;55;16;1365320;1369722;4402
"3032";63;3;33;17;1373133;1378827;5694
"3231";63;3;81;18;1384930;1391252;6322
"3361";63;3;93;19;1395139;1399876;4737
"3460";63;1;27;20;1405353;1410164;4811
"3632";63;1;91;21;1416441;1419575;3134
"3761";63;1;15;22;1423219;1427442;4223
"3961";63;3;9;23;1434272;1439541;5269
"4161";63;1;95;24;1445790;1450483;4693
"4260";63;3;57;25;1457718;1463274;5556
"4334";63;3;41;26;1466643;1471715;5072
"4459";63;3;49;27;1475813;1482290;6477
"4533";63;3;73;28;1486552;1492731;6179
"4660";63;3;61;29;1499362;1505464;6102
"4761";63;3;97;30;1511229;1515706;4477
"4834";63;3;53;31;1521347;1527381;6034
"4959";63;1;99;32;1530690;1535253;4563
"5061";63;1;51;33;1540812;1546021;5209
"5162";63;3;85;34;1594840;1602777;7937
"5262";63;3;37;35;1605719;1611402;5683
"5432";63;1;87;36;1617450;1620535;3085
"5560";63;3;29;37;1623463;1629260;5797
"5733";63;3;1;38;1634441;1638924;4483
"5932";63;1;71;39;1644162;1648809;4647
"6059";63;3;45;40;1651119;1655526;4407
"6133";63;1;3;41;1657951;1661459;3508
"6331";63;1;7;42;1667220;1672967;5747
"6559";63;1;35;43;1679296;1684471;5175
"6761";63;1;47;44;1693202;1697841;4639
"6861";63;3;77;45;1700465;1705185;4720
"6962";63;3;25;46;1708582;1714024;5442
"7133";63;3;17;47;1719507;1725738;6231
"7358";63;1;39;48;1731268;1735989;4721
"7561";63;1;19;49;1742624;1748939;6315
"7759";63;1;23;50;1754749;1759113;4364
"7959";63;4;98;51;1765057;1768663;3606
"8059";63;2;84;52;1772040;1776080;4040
"8161";63;4;82;53;1779066;1785138;6072
"8261";63;4;10;54;1788498;1793150;4652
"8460";63;2;92;55;1802492;1808095;5603
"8536";63;2;36;56;1811711;1816120;4409
"8731";63;4;38;57;1825440;1831336;5896
"8931";63;2;8;58;1839119;1845202;6083
"9167";63;4;54;59;1851004;1855227;4223
"9260";63;2;20;60;1861709;1865077;3368
"9461";63;2;48;61;1874727;1881601;6874
"9562";63;2;56;62;1884941;1890101;5160
"9636";63;2;44;63;1895487;1899684;4197
"9759";63;2;24;64;1902578;1906875;4297
"9960";63;2;40;65;1913059;1916023;2964
"10171";63;4;2;66;1921743;1927041;5298
"10356";63;2;72;67;1934313;1942607;8294
"10462";63;2;100;68;1945008;1949544;4536
"10536";63;2;16;69;1995180;1999981;4801
"10756";63;2;52;70;2006506;2011230;4724
"10837";63;4;62;71;2014373;2018614;4241
"10959";63;4;78;72;2021787;2025503;3716
"11033";63;2;96;73;2028124;2031055;2931
"11196";63;2;60;74;2033416;2037788;4372
"11260";63;2;12;75;2041062;2044913;3851
"11460";63;4;26;76;2051257;2055369;4112
"11661";63;4;86;77;2061965;2066129;4164
"11762";63;4;34;78;2068609;2073570;4961
"11961";63;2;68;79;2080809;2084145;3336
"12062";63;2;80;80;2086441;2091251;4810
"12197";63;4;94;81;2093805;2098260;4455
"12264";63;4;66;82;2100729;2105004;4275
"12339";63;4;18;83;2107826;2112532;4706
"12557";63;4;58;84;2118683;2123253;4570
"12637";63;4;6;85;2126463;2130902;4439
"12832";63;2;4;86;2137239;2139768;2529
"13057";63;2;28;87;2147225;2152718;5493
"13237";63;4;22;88;2160809;2166576;5767
"13432";63;2;76;89;2177190;2181857;4667
"13559";63;4;74;90;2184235;2188610;4375
"13633";63;2;88;91;2191705;2196883;5178
"13760";63;4;46;92;2199310;2204322;5012
"13858";63;2;64;93;2207190;2210915;3725
"13962";63;4;42;94;2213451;2217857;4406
"14036";63;4;30;95;2220552;2225140;4588
"14235";63;4;70;96;2232353;2240597;8244
"14360";63;4;50;97;2243866;2248790;4924
"14433";63;4;90;98;2252450;2257672;5222
"14560";63;2;32;99;2260420;2264031;3611
"14759";63;4;14;100;2273731;2279997;6266
"9168";64;4;97;1;1640879;1647783;6904
"10172";64;2;83;2;1650472;1652925;2453
"11197";64;4;81;3;1655768;1660158;4390
"12198";64;4;9;4;1662651;1666758;4107
"14144";64;2;91;5;1673840;1678874;5034
"1532";64;2;35;6;1681733;1684124;2391
"1733";64;4;37;7;1689602;1693823;4221
"1932";64;2;7;8;1699278;1701940;2662
"2133";64;4;53;9;1708705;1712548;3843
"2261";64;2;19;10;1715240;1718448;3208
"2462";64;2;47;11;1723426;1727022;3596
"2561";64;2;55;12;1729550;1735005;5455
"2633";64;2;43;13;1737403;1739805;2402
"2762";64;2;23;14;1742516;1745713;3197
"2961";64;2;39;15;1752114;1755646;3532
"3132";64;4;1;16;1761141;1766121;4980
"3362";64;2;71;17;1773740;1777712;3972
"3461";64;2;99;18;1780306;1785478;5172
"3533";64;2;15;19;1788673;1791228;2555
"3762";64;2;51;20;1798058;1801278;3220
"3832";64;4;61;21;1803822;1808428;4606
"3962";64;4;77;22;1810984;1816044;5060
"4033";64;2;95;23;1819292;1822761;3469
"4162";64;2;59;24;1825359;1828602;3243
"4261";64;2;11;25;1869071;1872250;3179
"4460";64;4;25;26;1877192;1881541;4349
"4661";64;4;85;27;1886809;1893850;7041
"4762";64;4;33;28;1896289;1900950;4661
"4960";64;2;67;29;1906093;1910382;4289
"5062";64;2;79;30;1912952;1915882;2930
"5163";64;4;93;31;1918252;1923549;5297
"5263";64;4;65;32;1925965;1930948;4983
"5333";64;4;17;33;1933479;1937565;4086
"5561";64;4;57;34;1943282;1947548;4266
"5631";64;4;5;35;1950148;1954639;4491
"5830";64;2;3;36;1960336;1964464;4128
"6060";64;2;27;37;1969953;1974705;4752
"6231";64;4;21;38;1979891;1985596;5705
"6431";64;2;75;39;1992688;1997496;4808
"6560";64;4;73;40;2001263;2006396;5133
"6633";64;2;87;41;2008840;2013295;4455
"6762";64;4;45;42;2015975;2020570;4595
"6862";64;2;63;43;2023041;2027853;4812
"6963";64;4;41;44;2030295;2036144;5849
"7033";64;4;29;45;2038785;2046453;7668
"7231";64;4;69;46;2051742;2056052;4310
"7359";64;4;49;47;2059205;2066727;7522
"7433";64;4;89;48;2155075;2158549;3474
"7562";64;2;31;49;2164421;2168256;3835
"7760";64;4;13;50;2176210;2181064;4854
"7960";64;3;64;51;2222444;2226746;4302
"8060";64;3;80;52;2229183;2234088;4905
"8162";64;3;44;53;2236538;2240371;3833
"8262";64;3;68;54;2242801;2246987;4186
"8332";64;1;70;55;2249284;2252712;3428
"8461";64;3;12;56;2255136;2260720;5584
"8631";64;1;6;57;2268183;2272520;4337
"8831";64;3;32;58;2279011;2281811;2800
"9031";64;1;22;59;2287736;2292011;4275
"9261";64;3;60;60;2297885;2303527;5642
"9334";64;1;90;61;2307092;2311660;4568
"9462";64;1;66;62;2313903;2319268;5365
"9563";64;1;14;63;2322038;2327168;5130
"9760";64;3;76;64;2332846;2338951;6105
"9831";64;3;84;65;2341333;2348925;7592
"9961";64;3;56;66;2353614;2358200;4586
"10032";64;1;34;67;2360728;2362616;1888
"10235";64;1;82;68;2368159;2372291;4132
"10357";64;1;94;69;2374634;2377249;2615
"10463";64;3;28;70;2379562;2385249;5687
"10633";64;3;92;71;2390889;2397949;7060
"10757";64;3;16;72;2400377;2405182;4805
"10960";64;1;10;73;2410960;2416089;5129
"11198";64;3;96;74;2421058;2426722;5664
"11261";64;1;58;75;2430973;2434455;3482
"11336";64;1;42;76;2438266;2440963;2697
"11461";64;1;50;77;2443331;2446639;3308
"11534";64;1;74;78;2449007;2453147;4140
"11662";64;1;62;79;2455540;2458005;2465
"11763";64;1;98;80;2460844;2464846;4002
"11833";64;1;54;81;2467978;2471804;3826
"11962";64;3;100;82;2474370;2476304;1934
"12063";64;3;52;83;2478681;2482646;3965
"12199";64;1;86;84;2486065;2488720;2655
"12265";64;1;38;85;2491439;2494404;2965
"12433";64;3;88;86;2504423;2510078;5655
"12558";64;1;30;87;2512513;2517228;4715
"12732";64;1;2;88;2523836;2527010;3174
"12931";64;3;72;89;2532953;2540726;7773
"13058";64;1;46;90;2543295;2547643;4348
"13143";64;3;4;91;2550089;2554102;4013
"13332";64;3;8;92;2559667;2563251;3584
"13560";64;3;36;93;2568654;2574117;5463
"13761";64;3;48;94;2580485;2584817;4332
"13859";64;1;78;95;2587314;2591625;4311
"13963";64;1;26;96;2593973;2597200;3227
"14145";64;1;18;97;2602898;2606675;3777
"14361";64;3;40;98;2612344;2616766;4422
"14561";64;3;20;99;2623439;2628557;5118
"14760";64;3;24;100;2634183;2639307;5124
